SampleID	Type	Group
MSWLNFLKYIAKYGKKAVSAAWKYKGKVLEWLNVGPTLEWVWQKLKKIAGL	positive	group2
MNFNKFFVLFALIMVAVVGQSEAGWLKKLGKKIERVGQHTRDATIQTIGVAQQAVNVAATLKG	negative	group1
FVYGNGVTSILVQAQFLVNGQRRFFYTPDK	positive	group2
IYFIADKMGIQLAPAWYQDIVNWVSAGGTLTTGFAIIVGVTVPAWIAEAAAAFGIASA	positive	group1
CNPLNGADRRTDSFPRFTVI	negative	group2
KWKSFIKKLTSKFLHSAKKF	negative	group1
GLGSILGKILNVAGKVGKTIGKVADAVGNKE	negative	group1
GSKKPVPIIYCNRRTGKCQR	positive	group1
DFASCHTNGGICLPNRCPGHMIQIGICFRPRVKCCRSW	negative	group1
GKNGVFKTISHECHLNTWAFLATCCS	positive	group1
KLWKLFKKIGIGAVLKVLTTGLPALKLTK	negative	group1
SLQPGAPNVNNKDQPWQVSPHISRDDSGNTRTNINVQRHGENNDFEAGWSKVVRGPNKAKPTWHIGGTHRW	negative	group2
AKCIKNGKGCREDQGPPFCCSGFCYRQVGWARGYCKNR	positive	group2
LFRKQLKW	negative	group1
KYYGNGVSCNKKGCSVDWGKAIGIIGNNSAANLATGGAAGWSK	positive	group1
IHHIHHIIHHIHHI	negative	group1
GSKKPVPIIYCNRRTGKCQ	positive	group1
VTCDLLSFEAKGFAANHSLCAAHCLAIGRRGGSCERGVCICRR	positive	group2
QNICPRVNRIVTPCVAYGLGRAPIAPCCRALNDLRFVNTRNLRRAACRCLVGVVNRNPGLRRNPRFQNIPRDCRNTFVRPFWWRPRIQCGRINLTDKLIYL	positive	group1
GFFGNTWKKIKGKADKIMLKKAVKIMVKKEGISKEEAQAKVDAMSKKQIRLYLLKHYGKKALQKASEKL	negative	group1
GIRDVLKGAAKAFVKTVAGHIAN	negative	group2
LLPILGNLLNGLL	positive	group1
MQFITDLIKKAVDFFKGLFGNK	negative	group1
KKLKAFLKAWAKLFKAL	negative	group2
ASSGWVCTLTIECGTVICACR	positive	group1
LSCKRGTCHFGRCPSHLIKGSCSGG	positive	group1
KKKKAAFLKLWLKLFAA	negative	group1
ENFFKEIERAGQRIRDAIISAAPAVETLAQAQKIIKGGD	positive	group2
GCRFCCNCCPNMSGCGVCCRF	negative	group1
VFHLLGKIIHHVGNFVYGFSHVF	positive	group1
GVLDAFRKIATVVKNVV	positive	group2
RERSKGSKYLYVG	positive	group1
AIKIRKLFKKLLR	negative	group1
PNDPDSPCVYRMPNARGCSI	negative	group2
LFGSVKAWFKGAKKGFQDYRYQKDMAKMNKRYGPNWQQRGGQEPPADAQANDQPP	positive	group1
ATCDLASGFGVGSSLCAAHCLVKGYRGGYCKNKICHCRDKF	positive	group2
KWKLFKKIGIGAVLKVLTTGLPALKLTLK	negative	group2
EADEPLWLYKGDNIERAPTTADHPILPSIIDDVKLDPNRRYA	positive	group1
MGAIAKLVAKFGWPIVKKYYKQIMQFIGEGWAINKIIDWIKKHI	positive	group1
CVKVQVKVGSGVKVQVKVC	negative	group2
ATCDLLSAFGVGHAACAAHCIGHGYRGGYCNSKAVCTCRR	positive	group1
VDKPPYLPRPRPPRRIYNR	negative	group1
SNGDGTLDAGSTCAPFYARA	negative	group1
SDDEDEEEEEDQPWQLNPNIARGDDGNTRADVNIKRRGENHDFEAGWSKVVDGPDRAKPTWHVGGTFRW	positive	group2
MSYEKLNNEELSKILGGNGINWGAVAGSCASGAVIGAAFGNPLTGCVANSAFSFSWQAFKNRPRPKKIA	positive	group2
IIEKLVNTALGLLSGL	positive	group1
FIHHAAGGLFSAGKAIHRLIRRRRR	negative	group1
SALVGCWTKSWPPKPCFGRG	positive	group2
AKCLRWQWEMRKYGG	negative	group1
GLKKLLGKLLKKLGKLLLK	negative	group1
CTFTLPGGGGVCTLTSECIC	positive	group1
AKVLKISRRAFRK	negative	group1
KCRRRKVHGPMIRIRKKNL	negative	group1
FLPGLIAGIAKML	positive	group2
FLPLVGKILSGLI	positive	group1
APRKNLKW	negative	group1
KKLKLAPAKLALLWKALALKLKKA	negative	group1
ATCDLASKWNWNHTLCAAHCIARRYRGGYCNSKAVCVCR	positive	group1
ASGWVCTLTIECGTVICAC	positive	group2
LVAYGIAQGTAEKVVSLINAGLTVGSIISILGGVTVGLSGVFTAVKAAIAKQGIKKAIQL	positive	group2
ADDKNPLEEFRETNYEVFLEIAKNGLKATSNPKRVVIVGAGMAGLSAAY	negative	group1
GLLDALSGILGL	positive	group1
ATCDLASFSSQWVTPNDSLCAAHCLVKGYRGGYCKNKICHCRDKF	positive	group1
ATCDLASIWNVNHALCAAHCIARRYRGGYCNSKAVCVCR	positive	group1
RPIDTCRLRNGICFPGICRRPYYWIGTCNNGIGSCCARGWRS	negative	group2
FKRIVQRIKDFLRNLV	negative	group1
ISAAEFGKINGPIKK	negative	group1
KKLALHALKKWLHALKKLAHLALKK	negative	group1
SALVGCWTKSWPPKPCFGR	positive	group1
MRTGNAN	negative	group1
GIMDSVKNVAKNIAGQLLDKLKCKITGC	negative	group1
AGCIKNGGRCNASAGPPYCCSSYCFQIAGQSYGVCKNR	positive	group1
YYNPLPHDCGRDNNTDICSR	negative	group1
MLAKIKAMIKKFPNPYTLAAKLTTYEINWYKQQYGRYPWERPVA	positive	group2
GVLDIFKDAAKQILAHAAEKQI	negative	group2
ILAWKWAWWAWRR	positive	group1
APRKQLKW	negative	group1
IAPIIVAGLGYLVKDAWDHSDQIISGFKKGWNGGRRK	positive	group1
FWGKLWEGVKNAI	negative	group2
GLLSFLPKVIGVIGHLIHPPS	positive	group2
MGAIAKLVTKFGWPLIKKFYKQIMQFIGQGWTIDQIEKWLKRH	positive	group2
EPCSPKNNYHDLFYRT	negative	group1
SGIPCTIGAAVAASIAVCPTTKCSKRCGKRKK	positive	group1
GNAACVIGCIGSCVISEGIGSLVGTAFTLG	positive	group1
KWKSFIKKLTSAAKKVVTTAKPLISS	negative	group2
TVYTNA	positive	group2
KWKSFIKKLPKAAKKVVTTAKKPLIV	negative	group1
GLFDIVKKIAGHIAGSI	positive	group2
VTGELKRDKRVTCNIGEWVCVAHCNSKSKKSGYCSRGVCYCTN	negative	group1
GVLDILKNAAKNILAHAAEQI	negative	group1
AFRKQLKW	negative	group1
AKCLRWQWAMRKYGG	negative	group2
KFRKFGKQVWVRL	negative	group1
LLKWLLK	positive	group1
KKLALLALKKWLLALKKLALLALKK	negative	group1
TKYYGNGVYCNSKKCWVDWGTAQGCIDVVIGQLGGGIPGKGKC	positive	group1
VTSKSLCTPGCITGVLMCLTQNSCVSCNSCIRC	positive	group1
KWKSFIKKLTTAVKKVLTTGLPALIS	negative	group1
FLFSLIPNAISGLLSAFK	positive	group2
FLSIIAKVLGSLF	positive	group2
KIKKGFKKIFKRLPPIGVGVSIPLAGKR	negative	group1
GDDDDDD	negative	group1
YSYKKIDCGGACAARCRLSSRPRLCNRACGTCCARCNCVPPGTSGNTETCPCYASLTTHGNKRKCP	positive	group2
KFFKKLKNSVKKRAKKFFKKPKVIGVTFPF	positive	group1
FIITGLVRGLTKLF	positive	group1
MQIFVKTLTGKTITLEVEPSDTIENVKAKIQDKEGIPPDQQRLIFAGKQLEDGRTLSDYNIQKESTLHLVLRLR	positive	group1
ILKKLWEGVKSI	negative	group2
KKLALALKKLAPLWKKLALALKKA	negative	group2
VLSIVACSSGCGSGKTAASCVETCGNRCFTNVGSLC	positive	group2
KWKSFIKKLTSKFLHSADKF	negative	group2
LLPNLLKSLL	positive	group1
LRRIIRKIIHIIKK	negative	group2
TRDTNDLISSRTAAPSMV	negative	group1
GIKFFLKKLKKHI	negative	group1
FLPLLASLFSRLF	positive	group2
MAAFMKLIQFLATKGQKYVSLAWKRKGTILKWINAGQSFEWIYKQIKKLWA	positive	group1
GIFPKIIGKGIKTGIVNGIKSLVKGVGMKVFKAGLSNIGNTGCNEDEC	negative	group1
GFGCPLNQGACHNHCRSIRRRGGYCSGIIKQTCTCY	positive	group1
PNWTKIGKCAGSIAWAIGSGLFGGAKLIKIKKYIAELGGLQKAAKLLVGATTWEEKLHAGGYALINLAAELTGVAGIQANCF	positive	group1
KKKSFIKLLTSAKVSVLTTAKPLISS	negative	group1
NFLGTLINLAKKIM	positive	group1
DEKPKLILPTPAPPNLPQLVGGGGGNRKDGFGVSVDAHQKVWTSDNGGHSIGVSPGYSQHLPGPYGNSRPDYRIGAGYSYNF	negative	group2
TIDFGVRNINQSNLVYDTER	negative	group2
GILDKLKEFGISAARGVAQSLLNTASCKLAKTC	negative	group2
ILKKLLKKVKKI	negative	group2
RWIRWVWRKKLRI	negative	group2
ADRGWIKTLTKDCPNVISSICAGTIITACKNCA	positive	group1
GCWSTVLGGLKKFAKGGLEAIVNPK	negative	group2
GLFDIVKKIAGHIASSI	positive	group1
GCPQTPRCTNYAEKGQCPPN	negative	group2
HLNKRVQRELRGWLDWLK	negative	group2
KWNSFIKKLTSKFLHSAKKF	negative	group1
HLNKRVQRLLIRWLDWLK	negative	group1
LLGDFFRKAKEKIGKEFKRIVQR	positive	group2
GFGSLLGKALRLWKKVL	positive	group2
IHHIHHIIHHIHHIIHHIHHI	negative	group1
KYYGNGVHCTKSGCSVNWGEAFSAGVHRLANGGNGFW	positive	group1
KWKSFIKKAKTSFLHSAKKF	negative	group1
FKSWSFCTPGCAKTGSFNSYCC	positive	group1
KKINNPVSCLRKGGRCWNRCIGNTRQIGSCGVPFLKCCKRK	negative	group2
GSEIQPR	positive	group2
WYVKKCLNDVGICKKKCKPEEMHVKNGWAMCGKGRDCCVPAD	negative	group1
FTPSVSFSQNGGVVEAAAQRGYIYKKYPKGAKVPNKVKMLVNIRGKQTMRTCYLMSWTASSRTAKYYYYI	positive	group2
GILSNVLGMGKKIVCGLSGLC	negative	group1
KKLKLALAKLALLWKALALKLKKA	negative	group1
KKLKLALAKLAPLWKALALKLKKA	negative	group1
IHHIHHHIHHIHHH	negative	group1
RLGGILRKAGEKIGGGLKKIGQKIKDFFGKLAPRTES	negative	group2
KVPVGAIKKGGKAIKTGLGVVGAAGTAHEVYSHIRNRH	negative	group1
KKLALAPKKLALLWKKLALALKKA	negative	group2
GGAGHVPEYFVGIGTPISFYG	negative	group2
GLLQTIKEKLESLESLAKGIVSGIQA	positive	group2
GLFDIVKKLVSDF	negative	group1
GIFPKIIGKGIKTGIVNGIKSLVKGVGMKVFKAGLNNIGNTGCNEDEC	negative	group2
RYHMQCGYRGTFCTPGKCPHGNAYLGLCRPKYSCCRWL	negative	group1
FVGPVLKIAAGILPTAICKIYKKC	positive	group1
KWKSFLKTFKSLKKTVLHTALKAISS	negative	group1
ILGTILGLLKSL	positive	group1
RKKWFW	negative	group1
LLGDFFRKAKEKIGKEFKRIVQRIKDFLRNLVPRTES	negative	group2
CFKFKFKFGSGFKFKFKFC	negative	group1
APRRQLKW	negative	group1
FLGALWNVKKSVF	positive	group1
GFSSLFKAGAKYLLKSVGKAGAQQLACKAANNCA	positive	group1
VGECVRGRCPSGMCCSQFGYCGKGPKYCGR	positive	group2
HLLKRVQRELIRWLDWLK	negative	group1
DSIRDVSPTFNKIRRWFDGLFK	negative	group1
FKSWSLCTPGCARTGSFNSYCC	positive	group1
FLPIASLLGKYL	positive	group2
AVNIPFKVHLRCKAAFC	negative	group1
GLIGSIGKALGGLLVDVLKPKLQAAS	positive	group2
NKGCATCSIGAACLVDGPIPDFEIAGATGLFGLWG	positive	group2
GLFDVIKKVASVIGLASP	positive	group1
ALWKDILKNAGKAALNEINQIVQ	positive	group1
GRPNPVNNKPTPHPRL	negative	group1
KKKKKKALFALWLAFLA	negative	group1
KFKSFIKKLTSKFLHSAKKF	negative	group2
FLPILINLIHKGLL	positive	group1
VAIALKAAHYHTHKE	positive	group2
GFISTVKNLATNVAGTVIDTIKCKVTGGC	negative	group2
HLNKRVQRELIRWLDWLK	negative	group1
GLEESPGHPGQPGPPGPPGAPGP	positive	group1
WFRKQLKW	negative	group2
HLLKRVQRLLIGWLDWLK	negative	group1
GLLDTIKNTAKNLAVGLLDKIKCKMTGC	negative	group1
CKCRRRKVHGPMIRIRKK	negative	group2
FLPLFASLIGKLL	positive	group1
AGDPLADPNSQIVRQIMSNAAWGPPLVPERFRGMAVGAAGGVTQTVLQGAAAHMPVNVPIPKVPMGPSWNGSKG	negative	group1
GWAKLITKAIKKI	negative	group1
GKGSWSKKIEVIA	negative	group2
GLWNTKLEAGLLFAMGKLDLKRCLKAGGC	negative	group1
KKLAKLALLKWLLALKLLALKALKK	negative	group1
SLGPAIKATRQVCPKATRFVTVSCKKSDCQ	positive	group1
ATCDLASIWNWNHTLCAAHCIARRYRGGYCNSKAVCVCR	positive	group1
GVVDILKGAAKDIAGHLASKVMNKL	negative	group1
APKKQLKW	negative	group2
YSLQMGATAIKQVKKLFKKWGW	positive	group1
DAECEICKFVIQQVEAFIESNHSQAEIQKELNKLCSSVPSIFTQTCLSIARMVPYIIKKLEEHNSPGQVCQGLHLCKSS	positive	group2
AYPGNGVHCGKYSCTVDKQTAIGNIGNNAA	positive	group1
IRPAKLRWFKKIK	negative	group1
HSSGYTRPLRKPSRPIFIRPIGCDVCYGIPSSTARLCCFRYGDCCHL	positive	group2
FALALKALKKALKKLKKALKKAL	negative	group2
ITSISLCTPGCKTGALMGCNMKTATCHCSIHVSK	positive	group1
GLWSKIKETGKEAAKAAGKAALNKIAEAV	positive	group1
GLWSKIKEAAKAAGKAALNAVTGLVNQGDQPS	negative	group2
KGIGSALKKGGKIIKGGLGALGAIGTGQQVYEHVQNRQ	negative	group2
GLHKVMREVLGYERNSYKKFFLR	negative	group1
MRTGNAD	negative	group1
ALFSILRGLKKLGKMGQAFVNCEIYKKC	negative	group1
LLLRLLR	positive	group2
GTTVVNSTFSIVLGNKGYICTVTVECMRNCQ	positive	group1
FLSAIASMLGKFL	positive	group2
PGDIPPGIRNTVCLMQQGHCRLFMCRSGERKGDICSDPWNRCCVPYSVKDRR	negative	group2
KKLALLALKKWLPALKKLALLALKK	negative	group2
KWKSFIKKLPSAAKKVVTTAKPLALIS	negative	group1
KKKKPLFGLFFGLF	negative	group2
KKKKKKNGFAAWGAFGA	negative	group1
GATAIKQVKKLFKKWGW	positive	group1
FLGGILNTITGLL	positive	group1
RRQGPIFDTRPSPFNPNQPRPGPIY	positive	group1
FLGVVFKLASKVFPAVFGKV	positive	group1
LLAWCLVFLVIVQQVTSSPVPQSDTPLTSVQEVQRSLKRTARMTPLWRIMGTKPHGAYCQNHYECSTGICRKGHCSYS	negative	group1
ATYYGNGLYCNKQKHYTWVDWNKASREIGKIIVNGWVQH	positive	group1
HLLKRVQRELIGWLDWLK	negative	group1
GILSTIKDFAIKAGKGAAKGLLEMASCKLSGQC	negative	group1
MGAVIKVGAKVIGWGAASGAGLYGLEKILKK	positive	group1
KVWSRLRKIFSTR	negative	group1
KKLALALKKPALLWKKLALALKKA	negative	group1
KWKKFIKNLTKGGSKILTTGLPALIS	negative	group1
FLPFIAGVAAKFLPKIFCAISKKC	positive	group1
ILGPVLGLVSDTLDDVLGIL	positive	group1
QLKKCWNNYVQGHCRKICRVNEVPEALCENGRYCCLNIKELEAC	negative	group1
GLLGTLGNLLNGLGL	positive	group1
GNGVLKTISHECNMNTWQFLFTCC	positive	group2
KKKKKALFLKLWAAFLA	negative	group1
SIWGDIGQGVGKAAYWVGKAMGNMSDVNQASRINRKKKH	positive	group2
GLFDIIKKIAESFKFSEAIKKIIDFLG	negative	group2
DDFLCAGGCL	negative	group1
VIEPKCYKYEGKKCPPDINPVCGTDKRTYYNECALCVFIRQSTKKADKAIKIKKWGKC	negative	group1
TNWKKIGKCYAGTLGSAVLGFGAMGPVGYWAGAGVGYASFC	positive	group2
HLNKRVQRELIGWLDWLK	negative	group2
IGPDTKKCVQRKNACHYFECPWLYYSVGTCYKGKGKCCQKRY	negative	group2
IGKEFKRIVQRIKDFLRNLVPRTES	negative	group1
GWLKKIGKKIERVGQHTRDATIQVIGVAQQAANVAATAR	negative	group1
LPVNSPMNKGDTEVMKCIVEVISDTLSKPSPMPVSKECFETLRGDERILSILRHQNLLKELQDLALQGAKERTHQQ	positive	group1
FLPAIVGAAGKFLPKIFCAISKKC	negative	group1
MGALIKTGAKIIGSGAAGGLGTYIGHKILGK	positive	group2
IYWIADQFGIHLATGTARKLLDAVASGASLGTAFAAILGVTLPAWALAAAGALGATAA	positive	group2
RYPAVGYT	negative	group1
QLINSPVTCMSYGGSCQRSCNGGFRLGGHCGHPKIRCCRRK	negative	group1
KKAKAFAKAWAKAFKAA	negative	group1
DQMSDGVNYGKGSSLSKGGAKCGLGIVGGLATIPSGPLGWLAGAAGVINSCMK	positive	group1
KRKCPKTPFDNTPGAWFAHLILGC	negative	group2
KYYGNGVSCNKKGCSVDWGKAIGIIGNNSAANLATGGAAGWKS	positive	group2
KYYGNGVTCGKHSCSVDWGKATTCIINNGAMAWATGGHQGNHKC	positive	group1
GLFGVLAKVASHVVPAIAEHFQA	positive	group1
GSQLVYREWVGHSNVIKGPP	positive	group1
ILKKLLKGVKSI	negative	group1
GLADFLNKAVGKVVDFVKS	positive	group1
ALWKNMLKGIGKLAGQAALGAVKTLVGA	positive	group2
TCRTNRPCFYDLDLNVCRCS	negative	group1
CAKAKAKAGSGAKAKAKAC	negative	group1
GIKIRKLFKKLLR	negative	group1
ATPTITTSSATCGGIIVAASAAQCPTLACSSRCGKRKK	positive	group1
YDLSDSNCLPANRDKRYYVI	negative	group2
RRSRKNGIGYAIGYAFGAVERAVLGGSRDYNK	positive	group1
GIMDTVKNVAKNLAGQLLDKLKCKITAC	negative	group1
IDWKKLLDAAKKIL	positive	group1
ESEFDRQEYEECKRQCMQLETSGQMRRCVSQCDKRFEEDIDWSKYDNQD	positive	group1
GIMDSVKNAAKNLAGQLLDTIKCKITAC	negative	group2
KKKAAFLKLWAKLFKAL	negative	group1
GLLGGLLGPLLGGGGGGGGGLL	negative	group2
SILPTIVSFLSKFL	positive	group1
KWKKFIKSLTKSAAKTVVKTAKKPLIV	negative	group1
GFFGNTWKKIKGKADKIMLKKAVKIMVKKEGISKEEAQAKVDAMSKKQIRLYVLKHYGKKALQKASEKL	negative	group1
ALSILRGLEKLAKMGIALTNCKATKKC	negative	group2
VLPIIGNLLNSLL	positive	group1
KDRPKKPGLCPPRPQKPCVKECKNDDSCPGQQKCCNYGCKDECRDPIFVG	positive	group2
KWKLFKKI	negative	group1
KKLALKALLLWLKALLKLAKLALKK	negative	group1
GVVDILKGAGKDLLAHLVGKISEKV	negative	group1
FLSAITSLLGKLL	positive	group1
GLLDVVKGAAKNLLASALDKLKCKVTGC	positive	group2
KKLAKALKLPALLWLKLAKALKKA	negative	group1
GCFEDWSRCSPSTSRGTGVLWRDCDSYCKVCFKADRGECFDSPSLNCPQRLPNNKQCRCINARTAKDNRNPTCWA	positive	group2
NGEWGYVVTKGAFQATTDVIANGWVSSLGGGYFGKP	positive	group1
VYPFMWGGAYCFCDAELV	positive	group1
GLFDIAKKVIGVIGSL	positive	group1
KYYGNGVHCGKKTCYVDWGQATASIGKIIVNGWTQHGPWAHR	positive	group1
GLLSGILGAGKHIVCGLSGLC	negative	group2
SASIVKTTIKASKKLCRGFTLTCGCHFTGKK	positive	group1
GILGKLWEGVKSIF	negative	group2
CVHWQTNTARTSCIGP	positive	group2
RQRDPQQQYEQCQKHCQRRETEPRHMQTCQQRCERRYEKEKRKQQKR	positive	group1
MWGRILAFVAKYGTKAVQWAWKNKWFLLSLGEAVFDYIRSIWGG	positive	group1
SFHVFPPWMCKSLKKC	negative	group2
HSHACTSYWCGKFCGTASCTHYLCRVLHPGKMCACVHCSR	positive	group2
HFKIRKRFVKKLV	negative	group2
GILDTIKSIASKVWNSKTVQDLKRKGINWVANKLGVSPQAA	negative	group2
SFPFFPPGICKRLKRC	negative	group1
IHHIHHI	negative	group2
DWTCWSCLVCAACSVELLNLVTAATGASTAS	positive	group2
KWKSFIKKLTSAAKKVLTTGLPALIS	negative	group1
ILKKLLKKVKSI	negative	group1
KLLKKGGKLLKKGGKLLKKGG	negative	group1
GAILCNLCKDTVKLVENLLTVDGAQAVRQYIDNLCGKASGFLGTLCEKILSFGVDELVKLIENHVDPVVVCEKIHAC	positive	group1
ITSKSLCTPGCKTGILMTCPLKTATCGCHFG	positive	group1
DIPPGIRNTVCFMQRGHCRLFMCRSGERKGDICSDPWNRCCVSSSIKNR	negative	group1
RIVELTLPRVSVRL	negative	group2
ETESTPDYLKNIQQQLEEYTKNFNTQVQNAFDSDKIKSEVNNFIESLGKILNTEKKEAPK	positive	group2
KKLAKALKLLALLWLKLAKALKKA	negative	group1
GLLDLAKHVIGIASKL	positive	group1
KYYGNGLSCSKKGCTVNWGQAFSCGVNRVATAGHGK	positive	group1
GLFDIIKKVASVIGGL	positive	group1
GLMSSIGKALGGLIVDVLKPKTPAS	positive	group1
IRRIIRKIIHIIKK	negative	group1
RQRDPQQQYEQCQKRCQRRETEPRHMQICQQRCERRYEKEKRKQQKRYEEQQREDEEKYEERMKEGD	positive	group1
FISAIASFLGKFL	positive	group1
SLQPGAPNINNKDQPWQVSPHISRDDNGNTRTNINVQRHGENNDFEAGWSKVVRGPNKAKPTWHIGGTHRW	negative	group1
IRRWRLHWFRRAI	negative	group1
ATRSYGNGVYCNNSKCWVNWGEAKENIAGIVISGWASGLAGMGH	positive	group1
LFCKRGTCHFGRCPSHLIKVGSCFGFRSCCKWPWDA	positive	group1
RLVRILVSKRPVAIKPYFRL	negative	group1
DPQTECQQCQRRCRQQESGPRQQQYCQRRCKEICEEEEEYN	positive	group1
KLIPIASKTCPAGKNLCYKI	negative	group1
AGECVQGRCPSGMCCSQFGYCGRGPKYCGR	positive	group2
GLWQKIKDKASELVSGIVEGVK	positive	group2
ITSVSWCTPGCTSEGGGSGCSHCC	negative	group1
FLFSLIPHAISGLISAFK	positive	group2
IHHIHHHIHHIHHHIHHIHHH	negative	group1
GFKDWIKGAAKKLIKTVASSIANE	negative	group1
KPAWCWYTLAMCGAGYDSGTCDYMYSHCFGVKHSSGGGGSYHC	positive	group1
RWIRWVWRKKLR	negative	group1
SCNCVCGVCCSCSP	positive	group1
GRPNPVNTKPTPYPRL	negative	group2
SDCNINSNTAADVILCFNQVGSCALCSPTLVGGPVP	positive	group1
KKLAKALKLLAPLWLKLAKALKKA	negative	group1
LVNQLGISKSLANTILGAIAVGNLASWVLALVPGPGWATKAALATAETIVKHEGKAAAIAW	positive	group2
ATCDLASGFGVGSSLCAAHCIARRYRGGYCNSKAVCVCRN	positive	group1
KWKSFIKKLTSKFLHLAKKF	negative	group1
CFLPKLFAKITKKNMAHIR	negative	group1
KKKKAAFAKAWAKAFAA	negative	group1
GVGSFIHKVVSAIKNVA	positive	group1
GIVDFAKGVLGKIKNVLGI	positive	group2
GLFDKLKSLVSDF	negative	group1
ATCDLASKWNVNHTLCAAHCIARRYRGGYCNSKAVCVCR	positive	group2
YVDREINLFDHYCIISRSPHISRWELKWQATVTCPGWTPVKGKVRGYSNPLSAEREATRDFVQRIVQRGLVTRDEASEWL	negative	group1
ALWKDVLKKIGTVALHAGKAALGAVADTISQ	positive	group1
SYSMEHFRWGKPV	positive	group2
EKCLRWQWRMRKYGG	negative	group1
FFSLIPSLVGGLISAFK	positive	group1
FIHHIIGGLISVGKHIHGLIHGH	positive	group1
GTPLALLGGAATGVIGYISNQTCPTTACTRAC	positive	group1
FLFPLITSFLSKVL	positive	group2
KWKSFLKTFKSAKKTVLHTALKLISS	negative	group1
KCSWWNASCHLGNNGKICTVSHECAAGCNL	positive	group1
GLPQDCERRGGFCSHKSCPPGIGRIGLCSKEDFCCRSRWYS	negative	group2
GLVTDTLKGAAKTVAAELLRKAH	negative	group1
ATCDLLSGTGIKHSACAAHCLLRGNRGGYCNGRAICVCRN	positive	group1
FLGMIPGLIGGLISAFK	positive	group1
AFALKKK	positive	group1
GSCSCSGTISPYGLRTCRATKTKPSHPTTKETHPQTLPT	positive	group1
NAMRGAKRVWRHI	negative	group2
GLLGLLGSVVSHVLPAITQHL	positive	group1
GIGKHVGKALKGLKGLLKGLGES	negative	group1
GVIDAAKKVVNVLKNLP	positive	group2
ATCDLASKFNVNHTLCAAHCIARRYRGGYCNSKAVCVCR	positive	group1
LSVDKRPVLHPEHIYGHNHY	negative	group1
GLFDIIKKIAESI	positive	group2
WNDTGKDADGAEY	positive	group1
VNYGNGVSCSKTKCSVNWGQAFQERYTAGINSFVSGVASGAGSIGRRP	positive	group1
IPVLCPVCTSLVGKLIDLVLGGAVDKVTDYLETLCAKADGLVETLCTKIVSYGIDKLIEKILEGGSAKLICGLIHAC	positive	group2
AKCLRWQWEMRKVGG	negative	group1
ALFSILRGLKKLGNMGQAFVNCKIYKKC	negative	group2
SDEKASPDKHHRFSLSRYAKLANRLANPKLLETFLSKWIGDRGNRSVK	positive	group2
MPCSCKKYCDPWEVIDGSCGLFNSKYICCREK	negative	group1
LKKLLKWLLKLLK	positive	group1
GLGSFFKNAIKIAGKVGSTIGKVADAIGNKE	negative	group1
WNDTGKDADGSEY	positive	group1
GKPRPYSPRPTSHPRPIRV	negative	group1
NIPQLTPTP	positive	group1
DPQTDCQQCQRRCRQQESGPRQQQYCQRRCKEICEEEEEYN	positive	group1
FLPAIVGAAGQFLPKIFCAISKKC	negative	group1
KKLAKAPKLLALLWLKLAKALKKA	negative	group1
DEKPKLILPTPAPPNLPQLVGGGGGNRKDGFGVSVDAHQKVWTSDNGRHSIGVTPGYSQHLGGPYGNSRPDYRIGAGYSYNF	negative	group1
QINWGSVVGHCIGGAIIGGAFSGGAAAGVGCLVGSGKAIINGL	positive	group2
KKKKKKAGFAAWAAFGA	negative	group1
KKLALKALKLWLLALLKLAKLALKK	negative	group1
ITSISLCTPGCKTGALMGCNMKTATCNCSIHVSK	positive	group1
KKLALALAKKWLALAKKLALALAKK	negative	group1
GLFDIVKKVVGAIGSL	positive	group1
QQCGRQAGNRRCANNLCCSQYGYCGRTNEYCCTSQGCQSQCRRCG	positive	group1
RQRDPQQQYEQCQKHCQRRETEPRHMQTCQQRCERRYEKEKRKQQKRYEEQQREDEEKYEERMKEED	positive	group1
QQCGRQASGRLCGNRLCCSQWGYCGSTASYCGAGCQSQCR	positive	group1
GSKKPVPIIYCNRRTGKC	positive	group1
QLEARFEPKQRNFRKRELDFEKLFANMPDY	positive	group1
DHHHDHGHDDHEHEELTLEKIKEKIKDYADKTPVDQLTERVQAGRDYLLGKGARPSHLPARVDRHLSKLTAAEKQELADYLLTFLH	positive	group2
GLFKTLIKGAGKMLGHVAKQFLGSQGQPES	positive	group1
FLPILASLAATLGPKLLCLITKKC	positive	group1
GLFDVIAKVASVIGGL	positive	group1
RKCNFLCKLKEKLRTVITSHIDKVLRPQG	positive	group1
FFPIVAGVAGQVLKKIYCTISKKC	negative	group2
FLPFLIPALTSLISSL	positive	group2
CSTNTFSLSDYWGNKGNWCTATHECMSWCK	positive	group2
FLSLIPHIVSGVAALAKHLG	positive	group1
LGALFRVASKVFPAVISMVK	positive	group2
VGTIIKIIKAIIDIFAK	positive	group2
GFLDIINKLGKTFAGHMLDKIKCTIGTCPPSP	positive	group1
ITPATPFTPAIITEITAAVIA	positive	group2
DATPHAALFFTVKDHTAGDN	negative	group1
RKWLFW	negative	group1
APRKNVKW	negative	group2
GLWSKIKEAAKTAGKAAMGFVNEMV	positive	group1
ATCDLLSASTPWGSLNHSACAAHCLTKRYKGGRCRNGICRCRR	positive	group2
KLLKLLK	positive	group1
GIMDTVKNAAKDLAGQLLDKLKCRITGC	negative	group1
DQYRCLQNGGFCLRSSCPSHTKLQGTCKPDKPNCCRS	negative	group1
KRDPQQREYEDCRRRCEQQEPRQQYQCQRRCREQQ	positive	group1
CMSYGGSCQRSCNGGFRLGGHCGHPKIRCCRRK	negative	group2
IHHIHHHIHHIHHHIHHIHHHIHHIHHH	negative	group1
KWKSFIKKLTSKALHSAKKF	negative	group2
FLFRVASKVFPALIGKFKKK	positive	group2
SLGVTLGAAGVYTATQTIATQIWKCGAVLTTSAECSRTGNSC	positive	group2
GIWDTLKNVGKAVLGKVLENV	negative	group1
GSEIRGPCIDRFCRVICRNNGYESGHCNRWARGCSCASWIGR	positive	group1
RESPSSRMECYEQAERYGYGGYGGGRYGGGYGSGRGQPVGQGVERSHDDNRNQPR	negative	group2
GLFDIIKKVASVVGGL	positive	group1
TVYTQA	positive	group2
HLNKRVQRLLIGWLDWLK	negative	group2
GILDFAKTVVGGIRNALGI	positive	group1
MAKEFGIPAAVAGTVLNVVEAGGWVTTIVSILTAVGSGGLSLLAAAGRESIKAYLKKEIKKKGKRAVIAW	positive	group1
QLPICGETCVLGGCYTPNCRCQYPICVR	negative	group1
GWFDVVKHIASAV	positive	group1
KKLALALKKLALLWKKLALALKKA	negative	group1
GNRPVYIPPPRPPHPRL	negative	group1
YSSKDCLKDIGKGIGAGTVAGAAGGGLAAGLGAIPGAFVGAHFGVIGGSAACIGGLLGN	positive	group1
VSTLSVSSPCPGWPSSFTWSNC	positive	group2
STNCFCYICCSCSS	positive	group1
FLPIVGKLLSGLL	positive	group1
WAIVLL	positive	group2
GDINGEFTTSPACVYSVMVVSKASSAKCAAGASAVSGAILSAIRC	positive	group1
GRRRSVQWCAVSQPEATKCFQWQRNMRKVRGPPVSCIKRDSPIQCIQA	negative	group2
RQRDPQQQYEQCQERCQRHETEPRHMQTCQQRCERRYEKEKRKQQKR	positive	group1
CVKVSVKVGSGVKVSVKVC	negative	group1
GIMDTVKNAAKDLAGQLDKLKCRITGC	negative	group1
KKWKKFIKKIGIGAVLTTPGAKK	negative	group1
VDKPDYRPRPRPPNM	negative	group2
GLVSSIGRALGGLLADVVKSKGQPA	negative	group1
APIIRRIPYYPEVESDLRIVDCKRSEGFCQEYCNYLETQVGYCSKKKDACCLH	negative	group2
GIFLDKLKNFAKGVAQSLLNKASCKLSGQC	negative	group2
ASGRDIAMAIGTLSGQFVAGGIGAAAGGVAGGAIYDYASTHKPNPAMSPSGLGGTIKQKPEGIPSEAWNYAAGRLCNWSPNNLSDVCL	negative	group1
DPQTECQQCQRRCRQQESDPRQQQYCQRRCKEICEEEEEYN	positive	group1
TTSIRRRYQVSLIRRHRGKR	negative	group1
TVVTQA	positive	group1
APAGLVAKFGRPIVKKYYKQIMQFIGEGSAINKIIPWIARMWRT	positive	group1
AGFLKVVQLLAKYGSKAVQWAWANKGKILDWLNAGQAIDWVVSKIKQILGIK	positive	group1
SLWENFKNAGKQFILNILDKIRCRVAGGCRT	positive	group1
ATTGCSCPQCIIFDPICASSYKNGRRGFSSGCHMRCYNRCHGTDYFQISKGSKCI	positive	group2
KWKSFIKKLLSKFLHSAKKF	negative	group1
LLGNFFRKSKQKIGKQFKRIVQRIKNFFRNLVPRTQS	positive	group2
TPVVNPPFLQQT	positive	group1
SILSGNFGVGKKIVCGLSGLC	negative	group2
QDKCKKVYENYPVSKCQLANQCNYDCKLDKHARSGECFYDEKRNLQCICDYCEY	positive	group1
FAEPLPSEEEGESYSKEVPEMEKRYGGFM	positive	group2
VGECVRGRCPSGMCCSQFGYCGKGPKYCG	positive	group1
ATCDLASKWNVNHALCAAHCIARRYRGGYCNSKAVCVCR	positive	group1
CEWYNISCQLGNKGQWCTLTKECQRSCK	positive	group1
GLFLDTLKGAAKDVAGKLEGLKCKITGCKLP	positive	group2
KKKKKAAFAKAWAAFAA	negative	group2
KKWWKFIKKAVNSGTTGLQTLAS	negative	group2
SDDAQRCYPHNRTPFTYTYI	negative	group1
VTCDLLSFKGQVNDSACAANCLSLGKAGGHCEKVGCICRKTSFKDLWDKRF	positive	group1
GWLRKIGKKIERVGQHTRDATIQVLGIAQQAANVAATAR	negative	group1
GFGSKPLDSFGLNFF	positive	group1
KLFKKIGIGAVLKVLTTGLPALKLTK	negative	group1
QWGYGGYGRGYGGYGGYGRGMYGGYGRGMYGGYGRGMYGGYGRGMYGGWGK	negative	group2
AVPAVRKTNETLD	positive	group2
FFDEKCNKLKGTCKNNCGKNEELIALCQKSLKCCRTIQPSGSIID	negative	group1
KKKKKKAAFAAWAAFAA	negative	group1
KWKSFIKKLTSKFLHSAKKN	negative	group1
GVNMYIRQIYDTCWKLKGHCRNVCGKKEIFHIFCGTQFLCCIERKEMPVLFVK	negative	group1
AALRGCWTKSIPPKPCSGKR	positive	group1
SCNCVCGFCCSCSPSA	positive	group1
GVIKSVLKGVAKTVALGML	negative	group1
YVSCLFRGARCRVYSGRSCCFGYYCRRDFPGSIFGTCSRRNF	positive	group1
ADDKNPLEECFRETDYEEFLEIARNGLKATSNPKRVV	positive	group1
CLGVGSCNNFAGCGYAIVCFW	positive	group2
LRPAVIVRTKAL	positive	group1
GDVMPESTPICAGFATLMSSIGLVKTIKGKC	positive	group1
FILPLIASFLSKFL	positive	group1
KKKKKKAGFAAWGAFGA	negative	group1
SLGVTLGAAGLYTATQTIATQIWKCGAVLTTSAECSRTGNSC	positive	group2
LPLPSCSSHGGDADNTSQRN	negative	group1
DYHHGVRVL	negative	group2
LLGDFFRKVKEKIGKEFKRIVQRIKDFLRNLVPRTES	negative	group2
LFKLLGKIIHHVGNFVHGFSHVF	positive	group2
GLLSGILGAGKNIVCGLSGLC	negative	group1
KWKSFIKKLTSKFLHSANKF	negative	group2
FFGAIAAALPHVISAIKNAL	positive	group1
KWKLFKKIGIGAVLKVLTTGLIALIS	negative	group1
ILGAIIPLVSGLLSHL	positive	group1
VNYGNGVSCSKTKCSVNWGIITHQAFRVTSGVASG	positive	group1
FLSAITSILGKFF	positive	group1
IRRRIRLIVRRQI	negative	group1
GFKDWIKGAAKKLIKTVAANIANQ	negative	group2
GILSGILGAGKSLVCGLSGLC	negative	group2
KPYCSCKWRCGIGEEEKGICHKFPIVTYVCCRRP	negative	group2
GFSSIFRGVAKFASKGLGKDLARLGVNLVACKISKQC	negative	group1
FVGAIAAALPHVISAIKNAL	positive	group1
GETDPNTQLLNDLGNNMAWGAALGAPGGLGSAALGAAGGALQTVGQGLIDHGPVNVFIPVLIGPSWNGSGSGYNSATSSSGSGS	negative	group1
KWKSFLKTFKSLKKTVLHTALKLISS	negative	group1
AAKIILNPKFRCKAAFC	negative	group1
KALKKFLKAWAKLFKAL	negative	group2
QAGGQTCPGGICCSQWGYCGTTADYCSPNNNCQSNCWASG	negative	group1
SLQPGAPNVNNKDQPWQVSPHISRDDSGNTRTDINVQRHGENNDFEAGWSKVVRGPNKAKPTWHIGGTHRW	negative	group1
GILDVAKTLVGKLRNVLGI	positive	group1
KWKFKKIGIGAVLKVLTTGLPALKLTLK	negative	group2
KKWGWLAWVEPAGEFLKGFGKGAIKEGNKDKWKNI	positive	group2
SPIHACRYQRGVCIPGPCRWPYYRVGSCGSGLKSCCVRNRWA	negative	group1
PVVDTTGNNPLQQQEEYYV	negative	group1
FLFSLIPSVIAGLVSAIRN	positive	group2
FLPLLASLFSGLF	positive	group1
APRKNVRF	negative	group2
GGYYCPFRQDKCHRHCRSFGRKAGYCGGFLKKTCICV	positive	group2
AKCLRWQWAMRKVGG	negative	group1
KSYGNGVQCNKKKCWVDWGSAISTIGNNSAANWATGGAAGWKS	positive	group2
GYHGGHGGHGGGYNGGGGHGGHGGGYNGGGHHGGGGHG	negative	group1
DICTNCCAGTKGCNTTSANGAFICEGQSDPKKPKACPLNCDPHIAYA	positive	group1
KRFKKFFKKLKNSVKKRAKKFFKKPRVIGVSIPF	negative	group2
GLGSFLKNAIKIAGKVGSTIGKVADAIGNKE	negative	group2
VLPLISMALGKLL	positive	group2
GLFDVIKKVASVIGGL	positive	group1
KKLALKALKLWLLALKKLALLALKK	negative	group1
GLLDIVKKVVGAFGSL	positive	group2
KWKSFLKTFKSAKKTVLHTLLKAISS	negative	group2
TVVTNA	positive	group2
APRKNVRW	negative	group2
FLYIVAKLLSGLL	positive	group1
ARSYGNGVYCNNKKCWVNRGEATQSIIGGMISGWASGLAGM	positive	group2
ITSHSLCTPGCAKTGSFNSFCC	positive	group1
GIGAAILSAGKSIIKGLANGLAEHF	negative	group1
KWKSFIKKLPSAAKKVTTAAKPLTK	negative	group2
KWKSFIKKLTSKFLHSKKKF	negative	group2
IHHIHHH	negative	group2
SLQPGAPNVNNKDQPWQVSPHISRDDSGNTNTDINLQRHGENHDFDAGWSKVVRGPNKAKPTWHVGGTYRW	negative	group1
KWKSFIKNLTKGGSKILTTGLPALIS	negative	group1
ATCDLLSGTGVKHSACAAHCLLRGNRGGYCNGRAICVCRN	positive	group1
IYWIADQFGIHLATGTARKLLDAMASGASLGTAFAAILGVTLPAWALAAAGALGATAA	positive	group1
TTPLCVGVIIGLTTSIKICK	positive	group1
ATYYGNGLYCNKQKCWVDWNKASREIGKIIVNGWVQHGPWAPR	positive	group1
FLPKLFAKITKKNMAHIRC	negative	group2
GLKEIFKAGLGSLVKGIAAHVAN	negative	group2
MTCGQVQGNLAQCIGFLQKGGVVPPSCCTGVKNILNSSRTTADRRAVCSCLKAAAGAVRGINPNNAEALPGKCGVNIPYKISTSTNCNSIN	positive	group1
TCRYWCKTPENQTYCCEDEREIPSKVGLKPGKCPPVRPVCPPTRGFFEPPKTCSNDGSCYGADKCCFDRCLGEHVCKPIQTRG	positive	group2
GADDDDD	negative	group1
WFYQGMNIAIYANIGGVANIIGYTEAAVATLLGAVVAVAPVVP	positive	group1
GSQLVYREWVGHSNVIKP	positive	group1
ECELAKVDGGYTPKNCAMAVGGGMLSGAIRGGMSGTVFGVGTGNLAGAFAGAHIGLVAGGLACIGGYLGSH	positive	group2
LTANLGISSYAAKKVIDIINTGSAVATIIALVTAVVGGGLITAGIVATAKSLIKKYGAKYAAAW	positive	group2
KYYGNGVTCGKHSCSVNWGQAFSCSVSHLANFGHGKC	positive	group2
HLNKRVQRELIGWLRWLK	negative	group1
ILKKWPWWPWRRK	positive	group1
GEILCNLCTGLINTLENLLTTKGADKVKDYISSLCNKASGFIATLCTKVLDFGIDKLIQLIEDKVDANAICAKIHAC	positive	group2
STALPVNSPMNKGDTEVMKCIVEVISDTLSKPSPMPVSQECFETLRGDERILSILRHQNLLKELQDLALQGAKERAHQQKK	positive	group1
KCPWWNLSCHLGNDGKICTYSHECTAGCNA	positive	group1
GLLSLLSLLGKLL	positive	group2
QVVRNPQSCRWNMGVCIPISCPGNMRQIGTCFGPRVPCCRRW	negative	group1
GYGGHGGHGGHGGHGGHGGHGHGGGGHG	negative	group1
KNYGNGVYCNKHKCSVDWATFSANIANNSVAMAGLTGGNAGNK	positive	group2
RRYGTCIYQGRLWAF	positive	group1
VLASKNFGDK	positive	group1
RRIRPRPPRLPRPRPRPLPFPRPGPRPIPRPLPFPRPGPRPIPRPLPFPRPGPRPIPRP	negative	group2
KKKAAFAKAWAKAFKAA	negative	group1
LPRDTSRCVGYHGYCIRSKVCPKPFAAFGTCSWRQKTCCVDTTSDFHTCQDKGGHCVSPKIRCLEEQLGLCPLKRWTCCKEI	negative	group1
GFLSTVKNLATNVAGTVIDTLKCKVTGGCRS	negative	group2
RLFIKKLKFITRR	negative	group2
KWKSFINKLTSKFLHSAKKF	negative	group2
KAAKKFAKAWAKAFKAA	negative	group1
SILPTIVSFLTKFL	positive	group2
FLPLLFGAISHLL	positive	group1
FFPLVLGALGSILPKIF	positive	group1
YITCLFRGARCRVYSGRSCCFGYYCRRDFPGSIFGTCSRRNF	positive	group1
LSIRRLLAAGVLKQTKGVGA	negative	group1
IIGHLIKTALGFLGL	negative	group2
CVKCKCKCGSGVKVKVKVC	negative	group2
KKLALALAKKWLPLAKKLALALAKK	negative	group2
KRFKKFFKKLKNSVKKRAKKFFKKPKVIGVTFPF	negative	group2
PCNPDHDYRPFGNFRIAFTT	negative	group1
MGAVAKFLGKAALGGAAGGATYAGLKKIFG	positive	group1
ATCDLASIFNVNHALCAAHCIARRYRGGYCNSKAVCVCRN	positive	group2
PLSCRRKGGICILIRCPGPMRQIGTCFGRPVKCCR	negative	group1
FFSASCVPGADKGQFPNLCRLCAGTGENKCA	negative	group2
AVLDILKDVGKGLLSHFMEKV	negative	group2
GMWSKIKNAGKAAKAAAKAAGKAALGAVSEAM	negative	group1
GLSQGVEPDIGQTYFEESRINQD	negative	group1
ACNFQSCWATCQAQHSIYFRRAFCDRSQCKCVFVRG	positive	group1
EIRLPEPFRFPSPTVPKPIDIDPILPHPWSPRQTYPIIARRS	positive	group1
FVPYNPPRPGQSKPFPSFPGHGPFNPKIQWPYPLPNPGH	negative	group1
YCNRRTGKCQRM	positive	group1
GIMDSVKGLAKNLAGKLLDSLKCKITGC	negative	group1
ELCEKASKTWSGNCGNTGHCDNQCKSWEGAAHGACHVRNGKHMCFCYFNC	positive	group1
FIHHIIGGLFSAGKAIHRLIR	positive	group1
CWKWKWKWGSGWKWKWKWC	negative	group2
RFRPPIRRPPIRPPFYPPFRPPIRPPIFPPIRPPFRPPLRFP	negative	group1
KRDPQQREYEDCRRRCEQQEPRQQHQCQLRCREQQ	positive	group2
GVIAAAKKVVNVLKNLF	positive	group2
GSSFCDSKCKLRCSKAGLADRCLKYCGICCEECKCVPSGTYGNKHECPCYRDKKNSKGKSKCP	positive	group2
PDPAKTAPKKGSKKAVTKA	negative	group1
KCKWWNISCDLGNNGHVCTLSHECQVSCN	positive	group1
PSVQGAAAQLTADVKK	negative	group1
FLSLLPSIVSGAVSLAKKLG	positive	group1
ALPKKLKYLNLFNDGFNYMGVV	negative	group2
KFFKKLKNSVKKRAKKFFKKPRVIGVSIPF	positive	group1
KWKSFIKKLASKFLHSAKKF	negative	group1
MGKLAIKAGKIIGGGIASALGWAAGEKAVGK	positive	group1
ILKKLLEGVKSI	negative	group2
FIHHIIGGLFSVGKHIHSLIHRRRR	positive	group1
ALSILKGLEKLAKMGIALTNCKATKKC	negative	group1
ASIIKTTIKVSKAVCKTLTCICTGSCSNCK	positive	group1
FLPFLAKILTGVL	positive	group1
RCTCTTIISSSSTF	positive	group1
GIGAAILSAGKSALKGLAKGLAEHF	negative	group2
ATCDLASIWNVNHTLCAAHCIARRYRGGYCNSKAVCVCR	positive	group1
GLVSSIGKVLGGLLADVVKSKGQPA	positive	group1
KKLKLALAKPALLWKALALKLKKA	negative	group2
KWFNEKSIQNKIDEKIGKNFLGGMAKAVVHKLAKNEFMCVANVDMTKSCDTHCQKASGEKGYCHGTKCKCGVPLSY	negative	group1
SGYLPGKEYVYKYKGKVF	positive	group2
GFRDVLKGAAKQFVKTVAGHIANI	negative	group1
FLPIIAKVLSGLL	positive	group2
FIAAIIGGLFSAGKAIHRLIRRRRR	positive	group2
GDVNWVDVGKTVATNGAGVIGGAFGAGLCGPVCAGAFAVGSSAAVAALYDAAGNSNSAKQKPEGLPPEAWNYAEGRMCNWSPNNLSDVCL	negative	group1
GLIGSIGKALGGLLVDVLKPKL	positive	group1
KWKSFIKKLTSVLKKVVTTAKPLISS	negative	group1
KPAWCWYTLAMCGAGYDSGTCDYMYSHCFGIKHHSSGSSSYHC	positive	group1
TTPATPAISILSAYISTNTCPTTKCTRAC	positive	group2
LASTLGISTAAAKKAIDIIDAASTIASIISLIGIVTGAGAISYAIVATAKTMIKKYGKKYAAAW	positive	group1
KKLAKLALLKWLLALKKLALLALKK	negative	group1
ATCDLASKFNWNHTLCAAHCIARRYRGGYCNSKAVCVCR	positive	group2
NRWYCNSAAGGVGGAAGCVLAGYVGEAKENIAGEVRKGWGMAGGFTHNKACKSFPGSGWASG	positive	group1
ILGIITSLLKSL	positive	group1
GFLSTVKNLATNVAGTVLDTIRCKVTGGCRP	negative	group1
WKVFKSFIKKASSFAQSVLD	negative	group1
GIGSAILSAGKSALKGLAKGLAEHFAN	negative	group1
SQLGDLGSGAGQGGGGGGSIRAAGGAFGKLEAAREEEFFYKKQKEQLERLKNDQIHQAEFHHQQIKEHEEAIQRHKDFLNNLHK	positive	group1
KTVNYGNGLYCNQKKCWVNWSETATTIVNNSIMNGLTGGNAGWHSGGRA	positive	group2
KWKKFIKKIGIGAVLKVLTTGLPALKLTKK	negative	group2
CVKVRVKVGSGVKVRVKVC	negative	group1
GLKEIFKAGLGSLVKGIAAHVAS	negative	group1
GAARKSIRLHRLYTWKATIYTR	positive	group1
ADNKNPLEECFRETNYEEFLEIAR	negative	group1
KRDPQQREYEDCRRHCEQQEPRLQYQCQRRCQEQQ	positive	group1
KNNWQTNVLEGGGAAFGGWGLGTAICAASGVGAPFMGACGYIGAKFGVDLWAGVTGATGGF	positive	group2
FSEAIKKIIDFLGEGLFDIIKKIAESF	negative	group2
AKKFGKAFVGEIM	negative	group2
GFFSTVKNLATNVAGTVIDTLKCKVTGGCRS	negative	group1
GLWEKVKEKANELVSGIVEGVK	positive	group1
KWKLFKKIGIGAVLKVLTPGLPALKLTK	negative	group1
GLKDIFKAGLGSLVKGIAAHVAN	negative	group1
VTCDLLSAEAKGVKVNHAACAAHCLLKRKRGGYCNKRRICVCRN	positive	group2
IHHIHHIIHHIHHIIHHIHHIIHHIHHI	negative	group1
STIVCVSLRICNWSLRFCPSFKVRCPM	positive	group1
IPAMEPAARVKRSPGYGGCSPRWACGGYG	positive	group2
LVATGMAAGVAKTIVNAVSAGMDIATALSLFSGAFTAAGGIMALIKKYAQKKLWKQLIAA	positive	group1
GNGVFKTISHECHLNTWAFLATCCS	positive	group1
ASIVKTTIKASKKLCRGFTLTCGCHFTGKK	positive	group1
LLKWLKK	positive	group1
SMLAYVDKNDHINPPHSPRS	negative	group1
EKCLRWQWRMRKVGG	negative	group1
KWKSFIKKLTDKFLHSAKKF	negative	group2
IHRDQQHESFLDARPEPGLTE	negative	group1
KWKSFKKKLTSKFLHSAKKF	negative	group1
KWKSFIKKSTSKFLHSAKKF	negative	group1
AAFRGCWTKNYSPKPCL	positive	group1
GFFGNAWKKIKGKAEKFFRKKAAKIIAKKEGITKEEAEAKVDTMSKKQIKVYLLKHYGKKALQKASEKL	negative	group1
MTPFWRGVSLRPVGASCRDNSECITMLCRKNRCFLRTASE	negative	group1
KTYYGTNGVHCTKKSLWGKVRLKNVIPGTLCRKQSLPIKQDLKILLGWATGAFGKTFH	positive	group1
VGHNADLQIKLSIRRLLAAGVLKQTKGVGA	negative	group2
LCNERPSQTWSGNCGNTAHCDKQCQDWEKASHGACHKRENHWKCFCYFNC	positive	group1
