SampleID	Type	Group
KPAWCWYTLAMCGAGYDSGTCDYMYSHCFGIKHHSSGSSSYHC	positive	group1
MQFITDLIKKAVDFFKGLFGNK	negative	group1
SLQPGAPNVNNKDQPWQVSPHISRDDSGNTRTNINVQRHGENNDFEAGWSKVVRGPNKAKPTWHIGGTHRW	negative	group2
RKCNFLCKLKEKLRTVITSHIDKVLRPQG	positive	group1
CKCRRRKVHGPMIRIRKK	negative	group1
KKLAKALKLLALLWLKLAKALKKA	negative	group1
FLYIVAKLLSGLL	positive	group2
IDWKKLLDAAKKIL	positive	group1
GLVTDTLKGAAKTVAAELLRKAH	negative	group1
FLPLLLAGLPLKLCFLFKKC	positive	group1
KWKSFIKKLTSKFLHSADKF	negative	group1
YSLQMGATAIKQVKKLFKKWGW	positive	group1
GNGVVLTLTHECNLATWTKKLKCC	positive	group1
CVKCKCKCGSGVKVKVKVC	negative	group1
FLGGILNTITGLL	positive	group1
GLFDIVKKLVSDF	negative	group2
KGIGSALKKGGKIIKGGLGALGAIGTGQQVYEHVQNRQ	negative	group1
GIMDTVKNAAKDLAGQLLDKLKCRITGC	negative	group2
GFVDFLKKVAGTIANVVT	positive	group2
CNPLNGADRRTDSFPRFTVI	negative	group1
FIITGLVRGLTKLF	positive	group1
FLFSLIPHAISGLISAFK	positive	group1
GWLKKIGKKIERVGQHTRDATIQVIGVAQQAANVAATAR	negative	group1
LSCKRGTCHFGRCPSHLIKGSCSGG	positive	group1
PDPAKTAPKKGSKKAVTKA	negative	group1
FLPIALKALGSIFPKIL	positive	group1
KWKSFLKTFKSLKKTVLHTALKLISS	negative	group1
RQRDPQQQYEQCQERCQRHETEPRHMQTCQQRCERRYEKEKRKQQKRYEEQQREDEEKYEERMKEED	positive	group1
ATCDLASIFNWNHTLCAAHCIARRYRGGYCNSKAVCVCR	positive	group2
TIDFGVRNINQSNLVYDTER	negative	group1
GLVDVLGKVGGLIKKLLPG	positive	group1
ALPKKLKYLNLFNDGFNYMGVV	negative	group1
DFASCHTNGGICLPNRCPGHMIQIGICFRPRVKCCRSW	negative	group2
GWGDVLCVAGTIGGAGTGGLGGAAAGSAVPVIGTGIGGAIGGVSGGLTGAATFC	positive	group1
AFRKQLKW	negative	group1
KRFKKFFKKLKNSVKKRAKKFFKKPKVIGVTFPF	negative	group1
ACNFQSCWATCQAQHSIYFRRAFCDRSQCKCVFVRG	positive	group1
ILKKLWEGVKSI	negative	group2
GIRDVLKGAAKAFVKTVAGHIAN	negative	group1
LLPIVGNLLNSLL	positive	group1
IRRWRLHWFRRAI	negative	group1
QQCGRQASGRLCGNRLCCSQWGYCGSTASYCGAGCQSQCR	positive	group1
KKLALHALKKWLHALKKLAHLALKK	negative	group1
KKLAKAPKLLALLWLKLAKALKKA	negative	group1
VDKPDYRPRPRPPNM	negative	group2
DCTRWIIGINGRICRD	positive	group1
TPVVNPPFLQQT	positive	group1
FLPFLASLLTKVL	positive	group1
IHHIHHI	negative	group1
GLLDIVKKVVGAFGSL	positive	group1
GLIGSIGKALGGLLVDVLKPKLQAAS	positive	group1
FLSAITSILGKFF	positive	group1
MGAIAKLVAKFGWPIVKKYYKQIMQFIGEGWAINKIIEWIKKHI	positive	group1
GKNGVFKTISHECHLNTWAFLATCCS	positive	group1
RWIRWVWRKKLR	negative	group2
ATCDLASKFNWNHTLCAAHCIARRYRGGYCNSKAVCVCR	positive	group1
FALALKALKKALKKLKKALKKAL	negative	group1
FLPKLFAKITKKNMAHIRC	negative	group1
GKGSWSKKIEVIA	negative	group1
TRDTNDLISSRTAAPSMV	negative	group1
GLFDIVKKVVGAFGSL	positive	group1
GSCSCSGTISPYGLRTCRATKTKPSHPTTKETHPQTLPT	positive	group2
VQETQKLAKTVGANLEETNKKLAPQIKSAYDDFVKQAQEVQKKLHEAASKQ	positive	group1
CLGVGSCNNFAGCGYAIVCFW	positive	group1
SCNCVCGVCCSC	positive	group2
FLPGLIAGIAKML	positive	group1
GFSSIFRGVAKFASKGLGKDLARLGVNLVACKISKQC	negative	group1
ATYYGNGLYCNKQKCWVDWNKASREIGKIIVNGWVQHGPWAPR	positive	group1
ATQSHQ	positive	group1
DAECEICKFVIQQVEAFIESNHSQAEIQKELNKLCSSVPSIFTQTCLSIARMVPYIIKKLEEHNSPGQVCQGLHLCKSS	positive	group2
SLQPGAPNVNNKDQPWQVSPHISRDDSGNTNTDINLQRHGENHDFDAGWSKVVRGPNKAKPTWHVGGTYRW	negative	group1
FAEPLPSEEEGESYSKEVPEMEKRYGGFM	positive	group1
GLHKVMREVLGYERNSYKKFFLR	negative	group1
GDDDDDD	negative	group1
WKVFKSFIKKASSFAQSVLD	negative	group1
AKVLKISRRAFRK	negative	group1
ILKKLLKKVKSI	negative	group1
FIHHIIGGLISVGKHIHGLIHGH	positive	group2
GIWDTLKNVGKAVLGKVLENV	negative	group1
RQRDPQQQYEQCQERCQRHETEPRHMQTCQQRCERRYEKEKRKQQ	positive	group1
VTCDLLSFEAKGFAANHSLCAAHCLAIGRRGGSCERGVCICRR	positive	group1
IHHIHHHIHHIHHHIHHIHHH	negative	group1
KWFNEKSIQNKIDEKIGKNFLGGMAKAVVHKLAKNEFMCVANVDMTKSCDTHCQKASGEKGYCHGTKCKCGVPLSY	negative	group1
GLKDIFKAGLGSLVKGIAAHVAN	negative	group1
ITSISLCTPGCKTGALMGCNMKTATCHCSIHVSK	positive	group2
GRRRSVQWCAVSQPEATKCFQWQRNMRKVRGPPVSCIKRDSPIQCIQA	negative	group1
VLPIIGNLLNSLL	positive	group2
ETESTPDYLKNIQQQLEEYTKNFNTQVQNAFDSDKIKSEVNNFIESLGKILNTEKKEAPK	positive	group1
DSIRDVSPTFNKIRRWFDGLFK	negative	group2
GFGCNGPWDEDDMQCHNHCKSIKGYKGGYCAKGGFVCKCY	positive	group1
FLQRIIGARGRLF	positive	group1
KWKSFIKKLTTAVKKVLTTGLPALIS	negative	group1
LTANLGISSYAAKKVIDIINTGSAVATIIALVTAVVGGGLITAGIVATAKSLIKKYGAKYAAAW	positive	group2
IHHIHHHIHHIHHHIHHIHHHIHHIHHH	negative	group1
FLFSLIPSAIAGLVSAIRN	positive	group1
GLLSLLSLLGKLL	positive	group1
HLNKRVQRELIRWLDWLK	negative	group1
AAFRGCWTKNYSPKPCL	positive	group1
NLCERASLTWTGNCGNTGHCDTQCRNWESAKHGACHKRGNWKCFCYFDC	positive	group1
KKWGWLAWVEPAGEFLKGFGKGAIKEGNKDKWKNI	positive	group1
ILKKLLKGVKSI	negative	group2
HLNKRVQRELRGWLDWLK	negative	group1
AKCLRWQWEMRKVGG	negative	group1
ILGAIIPLVSGLLSHL	positive	group1
DPQTECQQCQRRCRQQESGPRQQQYCQRRCKEICEEEEEYN	positive	group1
ESISVAGGTWNYGYGVGQAYSHYKHDYNNHGAKVVNSNNGVKDYKNAGPGVWAKASIGTVWDPATFYYNPTGFYSN	positive	group1
KKKKPLFGLFFGLF	negative	group1
GLFGVLAKVASHVVPAIAEHFQA	positive	group1
GLFDIIKKIAESFKFSEAIKKIIDFLG	negative	group2
GIMDTVKNAAKDLAGQLDKLKCRITGC	negative	group1
HFKIRKRFVKKLV	negative	group1
YITCLFRGARCRVYSGRSCCFGYYCRRDFPGSIFGTCSRRNF	positive	group1
GIMDTVKNVAKNLAGQLLDKLKCKITAC	negative	group1
PCNPDHDYRPFGNFRIAFTT	negative	group2
ALSILRGLEKLAKMGIALTNCKATKKC	negative	group1
ESEFDRQEYEECKRQCMQLETSGQMRRCVSQCDKRFEEDIDWSKYDNQE	positive	group2
FIHHIIGGLFSAGKAIHRLIR	positive	group2
MSWLNFLKYIAKYGKKAVSAAWKYKGKVLEWLNVGPTLEWVWQKLKKIAGL	positive	group1
RRSRKNGIGYAIGYAFGAVERAVLGGSRDYNK	positive	group1
FLGMIPGLIGGLISAFK	positive	group1
GIMDSVKGLAKNLAGKLLDSLKCKITGC	negative	group1
KKLALLALKKWLPALKKLALLALKK	negative	group1
QLPICGETCVLGGCYTPNCRCQYPICVR	negative	group1
YCNRRTGKCQRM	positive	group1
IRRIIRKIIHIIKK	negative	group1
FLGLIGSLL	positive	group1
YDLSDSNCLPANRDKRYYVI	negative	group1
GAILCNLCKDTVKLVENLLTVDGAQAVRQYIDNLCGKASGFLGTLCEKILSFGVDELVKLIENHVDPVVVCEKIHAC	positive	group1
GWAKLITKAIKKI	negative	group1
ATYYGNGLYCNKQKHYTWVDWNKASREIGKIIVNGWVQH	positive	group1
FSSLSLCSLGCTGVKNPSFNSYCC	positive	group1
KWKSFIKKLTDKFLHSAKKF	negative	group1
MLAKIKAMIKKFPNPYTLAAKLTTYEINWYKQQYGRYPWERPVA	positive	group1
GLPQDCERRGGFCSHKSCPPGIGRIGLCSKEDFCCRSRWYS	negative	group2
LLGDFFRKAKEKIGKEFKRIVQRIKDFLRNLVPRTES	negative	group1
KKKAAFAKAWAKAFKAA	negative	group1
KWKSFLKTFKSAKKTVLHTLLKAISS	negative	group1
GIMDSVKNVAKNIAGQLLDKLKCKITGC	negative	group2
RLVRILVSKRPVAIKPYFRL	negative	group1
AERVGAGAPVYL	positive	group1
IHRDQQHESFLDARPEPGLTE	negative	group2
IHHIHHHIHHIHHH	negative	group1
ALSILKGLEKLAKMGIALTNCKATKKC	negative	group2
HLLKRVQRELIGWLDWLK	negative	group1
KKLALALAKKWLPLAKKLALALAKK	negative	group1
GLFDIVKKVVGAIGSL	positive	group2
MTCGQVQGNLAQCIGFLQKGGVVPPSCCTGVKNILNSSRTTADRRAVCSCLKAAAGAVRGINPNNAEALPGKCGVNIPYKISTSTNCNSIN	positive	group1
IRPAKLRWFKKIK	negative	group1
RPIDTCRLRNGICFPGICRRPYYWIGTCNNGIGSCCARGWRS	negative	group1
RNKLAYNMGHYAGKATIFGLAAWALLA	positive	group1
KGGSGVIHTISHECNMNSWQFVFTCCS	positive	group1
GDCGGTCTWTKDCSICPSWSCWSWSC	positive	group1
VAGALGVQTAAATTIVNVILNAGTLVTVLGIIASIASGGAGTLMTIGWATFKATVQKLAKQSMARAIAY	positive	group1
GLLDVVKGAAKNLLASALDKLKCKVTGC	positive	group1
SALVGCWTKSYPPNPCFGRG	positive	group1
SILSGNFGVGKKIVCGLSGLC	negative	group1
KCPWWNLSCHLGNDGKICTYSHECTAGCNA	positive	group1
FFDEKCNKLKGTCKNNCGKNEELIALCQKSLKCCRTIQPSGSIID	negative	group1
AGECVQGRCPSGMCCSQFGYCGRGPKYCGR	positive	group2
GVIAAAKKVVNVLKNLF	positive	group1
IAPIIVAGLGYLVKDAWDHSDQIISGFKKGWNGGRRK	positive	group1
GFFSTVKNLATNVAGTVIDTLKCKVTGGCRS	negative	group1
SDDEDEEEEEDQPWQLNPNIARGDDGNTRADVNIKRRGENHDFEAGWSKVVDGPDRAKPTWHVGGTFRW	positive	group1
CEWYNISCQLGNKGQWCTLTKECQRSCK	positive	group1
APIIRRIPYYPEVESDLRIVDCKRSEGFCQEYCNYLETQVGYCSKKKDACCLH	negative	group1
SGYLPGKEYVYKYKGKVF	positive	group1
KKKSFIKLLTSAKVSVLTTAKPLISS	negative	group1
FIHHIIGGLFSVGKHIHSLIHRRRR	positive	group1
GADDDDD	negative	group1
KKKKKAAFAKAWAAFAA	negative	group1
KGLGKLIGIDWLLGQAKDAVKQYKKDYKRWH	positive	group1
GSEIRGPCIDRFCRVICRNNGYESGHCNRWARGCSCASWIGR	positive	group1
ILGTILGLLKSL	positive	group1
MQIFVKTLTGKTITLEVEPSDTIENVKAKIQDKEGIPPDQQRLIFAGKQLEDGRTLSDYNIQKESTLHLVLRLR	positive	group1
WNDTGKDADGAEY	positive	group1
ATCDLLSGTGVKHSACAAHCLLRGNRGGYCNGRAICVCRN	positive	group2
WWKWWWK	positive	group1
GILGKLWEGVKSIF	negative	group2
TKYYGNGVYCNSKKCWVDWGTAQGCIDVVIGQLGGGIPGKGKC	positive	group1
GWIRDFGKRIERVGQHTRDATIQTIAVAQQAANVAATLKG	positive	group2
STPACAIGVVGITVAVTGISTACTSRCINK	positive	group2
GSGVIPTISHECHMNSFQFVFTCCS	positive	group1
STALPVNSPMNKGDTEVMKCIVEVISDTLSKPSPMPVSQECFETLRGDERILSILRHQNLLKELQDLALQGAKERAHQQKK	positive	group2
ALFSILRGLKKLGNMGQAFVNCKIYKKC	negative	group1
ITSISLCTPGCKTGALMGCNMKTATCNCSVHVSK	positive	group1
YSSKDCLKDIGKGIGAGTVAGAAGGGLAAGLGAIPGAFVGAHFGVIGGSAACIGGLLGN	positive	group1
KKLALALKKLALLWKKLALALKKA	negative	group1
FLIGMTHGLICLISRKC	positive	group1
ITSKSLCTPGCKTGILMTCPLKTATCGCHFG	positive	group2
GNRPVYIPPPRPPHPRL	negative	group1
KWKSFIKKLTSAAKKVLTTGLPALIS	negative	group1
IYFIADKMGIQLAPAWYQDIVNWVSAGGTLTTGFAIIVGVTVPAWIAEAAAAFGIASA	positive	group1
KWKKFIKKIGIGAVLKVLTTGLPALKLTKK	negative	group2
GLLGLLGSVVSHVLPAITQHL	positive	group1
SLGVTLGAAGVYTATQTIATQIWKCGAVLTTSAECSRTGNSC	positive	group1
KKLAKLALLKWLLALKKLALLALKK	negative	group2
VDKPPYLPRPRPPRRIYNR	negative	group2
FLSLLPSIVSGAVSLAKKLG	positive	group1
SLWENFKNAGKQFILNILDKIRCRVAGGCRT	positive	group2
GVLDIFKDAAKQILAHAAEKQI	negative	group2
KKLAKLALLKWLLALKLLALKALKK	negative	group1
RYHMQCGYRGTFCTPGKCPHGNAYLGLCRPKYSCCRWL	negative	group1
DPQTECQQCQRRCRQQESDPRQQQYCQRRCKEICEEEEEYN	positive	group1
GRPNPVNTKPTPYPRL	negative	group2
EADEPLWLYKGDNIERAPTTADHPILPSIIDDVKLDPNRRYA	positive	group2
KWKSFIKKLTSKFLHSAKKN	negative	group1
SASIVKTTIKASKKLCRGFTLTCGCHFTGKK	positive	group1
VTSKSLCTPGCITGVLMCLTQNSCVSCNSCIRC	positive	group1
IPVLCPVCTSLVGKLIDLVLGGAVDKVTDYLETLCAKADGLVETLCTKIVSYGIDKLIEKILEGGSAKLICGLIHAC	positive	group2
DLWNSIKDMAAAAGRAALNAVTGMVNQ	positive	group1
GLFDVIKKVASVIGLASP	positive	group1
AKKFGKAFVGEIM	negative	group2
GLLSGILGAGKHIVCGLSGLC	negative	group1
KWKSFIKNLTKGGSKILTTGLPALIS	negative	group1
KCKWWNISCDLGNNGHVCTLSHECQVSCN	positive	group1
AFALKKK	positive	group1
QVVRNPQSCRWNMGVCIPISCPGNMRQIGTCFGPRVPCCRRW	negative	group1
DGVCSNRRQCNKEVCGSSYDVAIVGA	positive	group1
QCMQLETSGQMRRCVSQCDKRFEEDIDWSKYDNQE	positive	group1
ENFFKEIERAGQRIRDAIISAAPAVETLAQAQKIIKGGD	positive	group1
CVKVRVKVGSGVKVRVKVC	negative	group1
ATCDLASIFNVNHALCAAHCIARRYRGGYCNSKAVCVCRN	positive	group1
GLWQKIKDKASELVSGIVEGVK	positive	group1
KYYGNGVSCNSHGCSVNWGQAWTCGVNHLANGGHGVC	positive	group1
ATCDLASIFNVNHTLCAAHCIARRYRGGYCNSKAVCVCR	positive	group1
ILGIITSLLKSL	positive	group1
RRQGPIFDTRPSPFNPNQPRPGPIY	positive	group1
KRKCPKTPFDNTPGAWFAHLILGC	negative	group1
RKWLFW	negative	group2
ALWKDVLKKIGTVALHAGKAALGAVADTISQ	positive	group1
HLNKRVQRELIGWLDWLK	negative	group1
KWKFKKIGIGAVLKVLTTGLPALKLTLK	negative	group1
GILDTIKSIASKVWNSKTVQDLKRKGINWVANKLGVSPQAA	negative	group1
GIGKHVGKALKGLKGLLKGLGES	negative	group1
ATCDLASKFNVNHTLCAAHCIARRYRGGYCNSKAVCVCR	positive	group1
KPAWCWYTLAMCGAGYDSGTCDYMYSHCFGVKHSSGGGGSYHC	positive	group1
EKCLRWQWRMRKVGG	negative	group1
SLGPAIKATRQVCPKATRFVTVSCKKSDCQ	positive	group1
ATCDLASIWNVNHALCAAHCIARRYRGGYCNSKAVCVCR	positive	group2
LFKLLGKIIHHVGNFVHGFSHVF	positive	group1
ATCDLASGFGVGSSLCAAHCIARRYRGGYCNSKAVCVCRN	positive	group1
FTPSVSFSQNGGVVEAAAQRGYIYKKYPKGAKVPNKVKMLVNIRGKQTMRTCYLMSWTASSRTAKYYYYI	positive	group1
AIKIRKLFKKLLR	negative	group2
IGKEFKRIVQRIKDFLRNLVPRTES	negative	group1
AKCLRWQWAMRKVGG	negative	group2
IRRRIRLIVRRQI	negative	group1
CTFTLPGGGGVCTLTSECIC	positive	group1
IPAMEPAARVKRSPGYGGCSPRWACGGYG	positive	group1
SALVGCGTKSYPPKPCFGR	positive	group1
TTPATPAISILSAYISTNTCPTTKCTRAC	positive	group1
PNDPDSPCVYRMPNARGCSI	negative	group1
NGEWGYVVTKGAFQATTDVIANGWVSSLGGGYFGKP	positive	group1
GLMSSIGKALGGLIVDVLKPKTPAS	positive	group2
VIEPKCYKYEGKKCPPDINPVCGTDKRTYYNECALCVFIRQSTKKADKAIKIKKWGKC	negative	group1
SLQPGAPNVNNKDQPWQVSPHISRDDSGNTRTDINVQRHGENNDFEAGWSKVVRGPNKAKPTWHIGGTHRW	negative	group1
MNKEYNSISNFKKITNKDLQNINGGFIGRAIGDFVYFGAKGLRESGKLLNYYYKHKH	positive	group1
APRRQLKW	negative	group1
VYPFCWGGAYAFCKAKLV	positive	group1
GFLSTVKNLATNVAGTVLDTIRCKVTGGCRP	negative	group1
ITSFIGCTPGCGKTGSFNSFCC	positive	group1
KKKKAAFLKLWLKLFAA	negative	group1
FFGRLKSMWRGARGGLKAYKYQKDMAKMNKRYGPNWQQGGGQEPPADAQANDQPP	positive	group1
VNYGNGVSCSKTKCSVNWGQAFQERYTAGINSFVSGVASGAGSIGRRP	positive	group2
SLRGFLKGVGTALAGVGKVVADQFDKLLQAGQ	positive	group1
KYYGNGLSCNKSGCSVDWSKAISIIGNNAVANLTTGGAAGWKS	positive	group1
FLFRVASKVFPALIGKFKKK	positive	group2
APRKNVRF	negative	group1
LCNERPSQTWSGNCGNTAHCDKQCQDWEKASHGACHKRENHWKCFCYFNC	positive	group1
KKLKAFLKAWAKLFKAL	negative	group1
FVPYNPPRPGQSKPFPSFPGHGPFNPKIQWPYPLPNPGH	negative	group1
DDFLCAGGCL	negative	group1
GLFDVIKKVASVIGGL	positive	group2
RQRDPQQQYEQCQKHCQRRETEPRHMQTCQQRCERRYEKEKRKQQKR	positive	group1
GLFDIVKKIAGHIASSI	positive	group2
KWKSFIKKLASKFLHSAKKF	negative	group1
KALKKFLKAWAKLFKAL	negative	group1
FLPAIVGAAGKFLPKIFCAISKKC	negative	group1
RRYGTCIYQGRLWAF	positive	group1
GLFDIAKKVIGVIGSL	positive	group1
KDRPKKPGLCPPRPQKPCVKECKNDDSCPGQQKCCNYGCKDECRDPIFVG	positive	group1
FLGVVFKLASKVFPAVFGKV	positive	group1
VGECVRGRCPSGMCCSQFGYCGKGPKYCG	positive	group2
RFRPPIRRPPIRPPFYPPFRPPIRPPIFPPIRPPFRPPLRFP	negative	group2
DIPPGIRNTVCFMQRGHCRLFMCRSGERKGDICSDPWNRCCVSSSIKNR	negative	group1
FLPFIARLAAKVFPSIICSVTKKC	positive	group1
RCTCTTIISSSSTF	positive	group2
CVKVQVKVGSGVKVQVKVC	negative	group1
LPLPSCSSHGGDADNTSQRN	negative	group1
QAGGQTCPGGICCSQWGYCGTTADYCSPNNNCQSNCWASG	negative	group2
SQLGDLGSGAGQGGGGGGSIRAAGGAFGKLEAAREEEFFYKKQKEQLERLKNDQIHQAEFHHQQIKEHEEAIQRHKDFLNNLHK	positive	group1
GVIKSVLKGVAKTVALGML	negative	group2
IIGAIAAALPHVINAIKNTF	positive	group1
KKLKLAPAKLALLWKALALKLKKA	negative	group2
ATCDLLSAFGVGHAACAAHCIGHGYRGGYCNSKAVCTCRR	positive	group1
TYYGNGLYCNKEKCWVDWNQAKGEIGKIIVNGWVNH	positive	group1
KNNWQTNVLEGGGAAFGGWGLGTAICAASGVGAPFMGACGYIGAKFGVDLWAGVTGATGGF	positive	group1
SFPFFPPGICKRLKRC	negative	group1
SDEKASPDKHHRFSLSRYAKLANRLANPKLLETFLSKWIGDRGNRSVK	positive	group1
KKAKAFAKAWAKAFKAA	negative	group2
GLKKLLGKLLKKLGKLLLK	negative	group1
IHHIHHIIHHIHHIIHHIHHI	negative	group1
KVWSRLRKIFSTR	negative	group2
GWVACVGACGTVCLASGGVGTEFAAASYFL	positive	group1
GCWSTVLGGLKKFAKGGLEAIVNPK	negative	group2
GIKIRKLFKKLLR	negative	group1
ITSVSWCTPGCTSEGGGSGCSHCC	negative	group1
RQRDPQQQYEQCQKRCQRRETEPRHMQICQQRCERRYEKEKRKQQ	positive	group1
KWKSFIKKSTSKFLHSAKKF	negative	group1
PVVDTTGNNPLQQQEEYYV	negative	group2
KKLALALAKKWLALAKKLALALAKK	negative	group2
KKKKKKAGFAAWAAFGA	negative	group1
KKLALLALKKWLLALKKLALLALKK	negative	group2
GGYYCPFRQDKCHRHCRSFGRKAGYCGGFLKKTCICV	positive	group1
KWKSFIKKLPSAAKKVVTTAKPLALIS	negative	group1
KWKSFLKTFKSLKKTVLHTALKAISS	negative	group1
KRDPQQREYEDCRRHCEQQEPRLQYQCQRRCQEQQ	positive	group2
FLWGLIPGAISAVTSLIKK	positive	group1
GLFDIIKKVASVIGGL	positive	group1
GLWSKIKETGKEAAKAAGKAALNKIAEAV	positive	group1
RQRDPQQQYEQCQKHCQRRETEPRHMQTCQQRCERRYEKEKRKQQ	positive	group1
GLFDIVKKVVGALGSL	positive	group2
YSYKKIDCGGACAARCRLSSRPRLCNRACGTCCARCNCVPPGTSGNTETCPCYASLTTHGNKRKCP	positive	group2
LGALFRVASKVFPAVISMVK	positive	group1
GATAIKQVKKLFKKWGW	positive	group1
KKWWKFIKKAVNSGTTGLQTLAS	negative	group1
TVVTNA	positive	group1
GLSQGVEPDIGQTYFEESRINQD	negative	group1
GLWSKIKEAAKAAGKAALNAVTGLVNQGDQPS	negative	group1
KKLALALKKPALLWKKLALALKKA	negative	group1
YVSCLFRGARCRVYSGRSCCFGYYCRRDFPGSIFGTCSRRNF	positive	group2
CMSYGGSCQRSCNGGFRLGGHCGHPKIRCCRRK	negative	group1
KNYGNGVYCNKHKCSVDWATFSANIANNSVAMAGLTGGNAGNK	positive	group1
APAGLVAKFGRPIVKKYYKQIMQFIGEGSAINKIIPWIARMWRT	positive	group1
KWKLFKKIGIGAVLKVLTTGLIALIS	negative	group1
SMLAYVDKNDHINPPHSPRS	negative	group2
APRKNVKW	negative	group1
AVPAVRKTNETLD	positive	group1
CAKAKAKAGSGAKAKAKAC	negative	group1
QCIGNGGRCNENVGPPYCCSGFCLRQPGQGYGYCKNR	positive	group1
APRKNVRW	negative	group1
KKWKKFIKKIGIGAVLTTPGAKK	negative	group1
LLAWCLVFLVIVQQVTSSPVPQSDTPLTSVQEVQRSLKRTARMTPLWRIMGTKPHGAYCQNHYECSTGICRKGHCSYS	negative	group1
IIGHLIKTALGFLGL	negative	group1
LVNQLGISKSLANTILGAIAVGNLASWVLALVPGPGWATKAALATAETIVKHEGKAAAIAW	positive	group1
FLPLLASLFSGLF	positive	group1
KRKKHRCRVYNNGMPTGMYRWC	positive	group1
ATCDILSFQSQWVTPNHAGCALHCVIKGYKGGQCKITVCHCRR	positive	group1
SALVGCWTKSYPPKPCFGR	positive	group1
KCSWWNASCHLGNNGKICTVSHECAAGCNL	positive	group1
GFISTVKNLATNVAGTVIDTIKCKVTGGC	negative	group1
PGDIPPGIRNTVCLMQQGHCRLFMCRSGERKGDICSDPWNRCCVPYSVKDRR	negative	group1
GILSGILGAGKSLVCGLSGLC	negative	group1
KKLALKALLLWLKALLKLAKLALKK	negative	group2
APKKQLKW	negative	group1
KWKLFKKIGIGAVLKVLTPGLPALKLTK	negative	group1
NFLGTLINLAKKIM	positive	group1
RLGGILRKAGEKIGGGLKKIGQKIKDFFGKLAPRTES	negative	group2
GFFGNTWKKIKGKADKIMLKKAVKIMVKKEGISKEEAQAKVDAMSKKQIRLYLLKHYGKKALQKASEKL	negative	group1
GKPRPYSPRPTSHPRPIRV	negative	group1
HLNKRVQRELIGWLRWLK	negative	group1
GIGAAILSAGKSALKGLAKGLAEHF	negative	group1
KWKSFLKTFKSAKKTVLHTALKLISS	negative	group1
QWGRRCCGWGPGRRYCVRWC	positive	group1
GFRDVLKGAAKQFVKTVAGHIANI	negative	group1
GLFDIVKKVVGTLAGL	positive	group1
KKKKKKALFALWLAFLA	negative	group1
ITPATPFTPAIITEITAAVIA	positive	group2
ATCDLASFSSQWVTPNDSLCAAHCLVKGYRGGYCKNKICHCRDKF	positive	group1
GAWKNFWSSLRKGFYDGEAGRAIRR	positive	group1
GIGSAILSAGKSALKGLAKGLAEHFAN	negative	group1
KYYGNGVSCNKKGCSVDWGKAIGIIGNNSAANLATGGAAGWKS	positive	group2
GFKDWIKGAAKKLIKTVASSIANE	negative	group1
VTCDLLSFKGQVNDSACAANCLSLGKAGGHCEKVGCICRKTSFKDLWDKRF	positive	group1
GTTVVNSTFSIVLGNKGYICTVTVECMRNCQ	positive	group1
VFHLLGKIIHHVGNFVYGFSHVF	positive	group1
CSTNTFSLSDYWGNKGNWCTATHECMSWCK	positive	group1
LVATGMAAGVAKTIVNAVSAGMDIATALSLFSGAFTAAGGIMALIKKYAQKKLWKQLIAA	positive	group1
LKKLLKWLLKLLK	positive	group1
VIPFVASVAAEMMHHVYCAASKRC	positive	group1
FLPLFASLIGKLL	positive	group2
SILPTIVSFLTKFL	positive	group1
ESEFDRQEYEECKRQCMQLETSGQMRRCVSQCDKRFEEDIDWSKYDNQD	positive	group1
NRWYCNSAAGGVGGAAGCVLAGYVGEAKENIAGEVRKGWGMAGGFTHNKACKSFPGSGWASG	positive	group2
KWKKFIKNLTKGGSKILTTGLPALIS	negative	group1
ATTGCSCPQCIIFDPICASSYKNGRRGFSSGCHMRCYNRCHGTDYFQISKGSKCI	positive	group1
GILDKLKEFGISAARGVAQSLLNTASCKLAKTC	negative	group1
SDDAQRCYPHNRTPFTYTYI	negative	group2
ASGRDIAMAIGTLSGQFVAGGIGAAAGGVAGGAIYDYASTHKPNPAMSPSGLGGTIKQKPEGIPSEAWNYAAGRLCNWSPNNLSDVCL	negative	group1
TTPLCVGVIIGITASIKICK	positive	group1
WYVKKCLNDVGICKKKCKPEEMHVKNGWAMCGKGRDCCVPAD	negative	group1
RYPAVGYT	negative	group2
GYHGGHGGHGGGYNGGGGHGGHGGGYNGGGHHGGGGHG	negative	group2
SLGVTLGAAGLYTATQTIATQIWKCGAVLTTSAECSRTGNSC	positive	group1
GFLDIINKLGKTFAGHMLDKIKCTIGTCPPSP	positive	group2
TVVTQA	positive	group1
KWKSFIKKAKTSFLHSAKKF	negative	group1
FLPFLASLLSKVL	positive	group1
PSVQGAAAQLTADVKK	negative	group1
CFLPKLFAKITKKNMAHIR	negative	group1
GIKFFLKKLKKHI	negative	group1
ILKKLLEGVKSI	negative	group1
FLPAIVGAAGQFLPKIFCAISKKC	negative	group1
RIVELTLPRVSVRL	negative	group1
VTCDLLSAEAKGVKVNHAACAAHCLLKRKRGGYCNKRRICVCRN	positive	group1
FLPILASLAATLGPKLLCLITKKC	positive	group1
SDCNINSNTAADVILCFNQVGSCALCSPTLVGGPVP	positive	group1
GLFAVIKKVASVIGGL	positive	group1
KYYGNGLSCSKKGCTVNWGQAFSCGVNRVATAGHGK	positive	group1
HLNKRVQRLLIRWLDWLK	negative	group2
LLKLLKWLLKLLK	positive	group1
KKLALKALKLWLLALLKLAKLALKK	negative	group1
KSYGNGVQCNKKKCWVDWGSAISTIGNNSAANWATGGAAGWKS	positive	group1
FVYGNGVTSILVQAQFLVNGQRRFFYTPDK	positive	group1
TTPLCVGVIIGLTTSIKICK	positive	group1
AVLDILKDVGKGLLSHFMEKV	negative	group1
YVDREINLFDHYCIISRSPHISRWELKWQATVTCPGWTPVKGKVRGYSNPLSAEREATRDFVQRIVQRGLVTRDEASEWL	negative	group1
ALFSILRGLKKLGKMGQAFVNCEIYKKC	negative	group1
KYYGNGVHCGKHSCTVDWGTAIGNIGNNAAANWATGGNAGWNK	positive	group1
GFSSLFKAGAKYLLKSVGKAGAQQLACKAANNCA	positive	group1
KWKLFKKI	negative	group1
IYWIADQFGIHLATGTARKLLDAVASGASLGTAFAAILGVTLPAWALAAAGALGATAA	positive	group2
LGSCVANKIKDEFFAMISISAIVKAAQKKAWKELAVTVLRFAKANGLKTNAIIVAGQLALWAVQCGLS	positive	group1
RWKIFKKIEKMGRNIRDGIVKAGPAIEVLGSAKAIGK	positive	group2
GWFDVVKHIASAV	positive	group1
VTCDLLSIKGVAEHSACAANCLSMGKAGGRCENGICLCRKTTFKELWDKRF	positive	group1
KCRRRKVHGPMIRIRKKNL	negative	group1
TTSIRRRYQVSLIRRHRGKR	negative	group2
KPYCSCKWRCGIGEEEKGICHKFPIVTYVCCRRP	negative	group1
GSEIQPR	positive	group1
TVYTNA	positive	group1
GLLDTIKNTAKNLAVGLLDKIKCKMTGC	negative	group1
ATPTITTSSATCGGIIVAASAAQCPTLACSSRCGKRKK	positive	group1
FLFPLITSFLSKVL	positive	group2
RKKWFW	negative	group1
GLLDALSGILGL	positive	group2
GFGSLLGKALRLWKKVL	positive	group2
WFRKQLKW	negative	group1
ATCDLLSASTPWGSLNHSACAAHCLTKRYKGGRCRNGICRCRR	positive	group2
KWKSFIKKLTSKFLHLAKKF	negative	group1
MGAVAKFLGKAALGGAAGGATYAGLKKIFG	positive	group1
FKSWSLCTPGCARTGSFNSYCC	positive	group2
KYYGNGVTCGKHSCSVNWGQAFSCSVSHLANFGHGKC	positive	group1
VTGELKRDKRVTCNIGEWVCVAHCNSKSKKSGYCSRGVCYCTN	negative	group1
LLPILGNLLNGLL	positive	group1
ATCDLASIWNVNHTLCAAHCIARRYRGGYCNSKAVCVCR	positive	group1
STNCFCYICCSCSS	positive	group1
LPRDTSRCVGYHGYCIRSKVCPKPFAAFGTCSWRQKTCCVDTTSDFHTCQDKGGHCVSPKIRCLEEQLGLCPLKRWTCCKEI	negative	group1
ATCDLASIWNWNHTLCAAHCIARRYRGGYCNSKAVCVCR	positive	group2
GLFDVIAKVASVIGGL	positive	group2
KIIKVVK	positive	group1
SNGDGTLDAGSTCAPFYARA	negative	group2
ADNKNPLEECFRETNYEEFLEIAR	negative	group1
KIKKGFKKIFKRLPPIGVGVSIPLAGKR	negative	group1
ALWKNMLKGIGKLAGQAALGAVKTLVGA	positive	group1
EIRLPEPFRFPSPTVPKPIDIDPILPHPWSPRQTYPIIARRS	positive	group2
GLLDLAKHVIGIASKL	positive	group2
CFKFKFKFGSGFKFKFKFC	negative	group1
RWWWRWW	positive	group1
GGYYCPFFQDKCHRHCRSFGRKAGYCGGFLKKTCICV	positive	group1
GVVDILKGAAKDIAGHLASKVMNKL	negative	group1
GILSNVLGMGKKIVCGLSGLC	negative	group1
FNRGGYNFGKSVRHVVDAIGSVAGIRGILKSIR	positive	group1
FIHHAAGGLFSAGKAIHRLIRRRRR	negative	group2
KKKKKKAAFAAWAAFAA	negative	group1
LLGDFFRKVKEKIGKEFKRIVQRIKDFLRNLVPRTES	negative	group1
GLKEIFKAGLGSLVKGIAAHVAN	negative	group1
SNDSLWYGVGQFMGKQANCITNHPVKHMIIPGYCLSKILG	positive	group1
MAAFMKLIQFLATKGQKYVSLAWKRKGTILKWINAGQSFEWIYKQIKKLWA	positive	group1
GILDFAKTVVGGIRNALGI	positive	group1
LSIRRLLAAGVLKQTKGVGA	negative	group2
KWKKFIKSLTKSAAKTVVKTAKKPLIV	negative	group1
FKRIVQRIKDFLRNLV	negative	group1
DATPHAALFFTVKDHTAGDN	negative	group1
KWKSFKKKLTSKFLHSAKKF	negative	group1
DEKPKLILPTPAPPNLPQLVGGGGGNRKDGFGVSVDAHQKVWTSDNGRHSIGVTPGYSQHLGGPYGNSRPDYRIGAGYSYNF	negative	group1
KLIPIASKTCPAGKNLCYKI	negative	group1
SPIHACRYQRGVCIPGPCRWPYYRVGSCGSGLKSCCVRNRWA	negative	group1
FSEAIKKIIDFLGEGLFDIIKKIAESF	negative	group1
GIVDFAKGVLGKIKNVLGI	positive	group1
KKKKKALFLKLWAAFLA	negative	group1
GIMDSVKNAAKNLAGQLLDTIKCKITAC	negative	group2
GEILCNLCTGLINTLENLLTTKGADKVKDYISSLCNKASGFIATLCTKVLDFGIDKLIQLIEDKVDANAICAKIHAC	positive	group1
ALWKDILKNAGKAALNEINQIVQ	positive	group1
AAKIILNPKFRCKAAFC	negative	group1
KKLAKALKLPALLWLKLAKALKKA	negative	group2
VSTLSVSSPCPGWPSSFTWSNC	positive	group1
KKKKAAFAKAWAKAFAA	negative	group1
GILSTIKDFAIKAGKGAAKGLLEMASCKLSGQC	negative	group1
KKKKKKAGFAAWGAFGA	negative	group1
GVVDILKGAGKDLLAHLVGKISEKV	negative	group2
RQRDPQQQYEQCQKHCQRRETEPRHMQTCQQRCERRYEKEKRKQQKRYEEQQREDEEKYEERMKEED	positive	group1
SLGVTLGAAGVYTATQTIATQIWKCGAVLTTSAECSRTGKSC	positive	group1
FLPFIAGVAAKFLPKIFCAISKKC	positive	group1
IHHIHHH	negative	group1
VFQFLGKIIHHVGNFVHGFSHVF	positive	group1
ILKKLLKKVKKI	negative	group1
VNYGNGVSCSKTKCSVNWGIITHQAFRVTSGVASG	positive	group1
LRRIIRKIIHIIKK	negative	group2
KKKAAFLKLWAKLFKAL	negative	group1
GLGSFFKNAIKIAGKVGSTIGKVADAIGNKE	negative	group1
HSHACTSYWCGKFCGTASCTHYLCRVLHPGKMCACVHCSR	positive	group1
RESPSSRMECYEQAERYGYGGYGGGRYGGGYGSGRGQPVGQGVERSHDDNRNQPR	negative	group1
ATCDLASKWNVNHALCAAHCIARRYRGGYCNSKAVCVCR	positive	group2
GILDTLKQFAKGVGKWLVKGAAQ	positive	group1
GLFSVLGSVAKHLLPHVAPIIAEKL	positive	group1
KWKSFIKKLTSKALHSAKKF	negative	group1
GIFPKIIGKGIKTGIVNGIKSLVKGVGMKVFKAGLSNIGNTGCNEDEC	negative	group1
KRDPQQREYEDCRRRCEQQEPRQQYQCQRRCREQQ	positive	group1
GLFDKLKSLVSDF	negative	group1
ITSISLCTPGCKTGALMGCNMKTATCNCSIHVSK	positive	group1
GLFDIIKKIAESI	positive	group2
GIFLDKLKNFAKGVAQSLLNKASCKLSGQC	negative	group1
DICTNCCAGTKGCNTTSANGAFICEGQSDPKKPKACPLNCDPHIAYA	positive	group2
CIGNGGRCNENVGPPYCCSGFCLRQPNQGYGVCRNR	positive	group1
RRIRPRPPRLPRPRPRPLPFPRPGPRPIPRPLPFPRPGPRPIPRPLPFPRPGPRPIPRP	negative	group1
RWIRWVWRKKLRI	negative	group1
GDVNWVDVGKTVATNGAGVIGGAFGAGLCGPVCAGAFAVGSSAAVAALYDAAGNSNSAKQKPEGLPPEAWNYAEGRMCNWSPNNLSDVCL	negative	group1
GLLGTLGNLLNGLGL	positive	group1
GRPNPVNNKPTPHPRL	negative	group1
VGTIIKIIKAIIDIFAK	positive	group1
KVPVGAIKKGGKAIKTGLGVVGAAGTAHEVYSHIRNRH	negative	group1
GDVMPESTPICAGFATLMSSIGLVKTIKGKC	positive	group1
FFPIVAGVAGQVLKKIYCTISKKC	negative	group2
VLASKNFGDK	positive	group1
EKCLRWQWRMRKYGG	negative	group1
QLINSPVTCMSYGGSCQRSCNGGFRLGGHCGHPKIRCCRRK	negative	group1
VFHAYSARGVRNNYKSAVGPADWVISAVRGFIHG	positive	group1
IGGALGNALNGLGTWANMMNGGGFVNQWQVYANKGKINQYRPY	positive	group2
GNGVIKTISHECHMNTWQFIFTCCS	positive	group1
GCRFCCNCCPNMSGCGVCCRF	negative	group1
CVHWQTNTARTSCIGP	positive	group2
IHHIHHIIHHIHHI	negative	group1
GLGSFLKNAIKIAGKVGSTIGKVADAIGNKE	negative	group1
HLLKRVQRLLIGWLDWLK	negative	group1
DKLIGSCVWGATNYTSDCNAECKRRGYKGGHCGSFWNVNCWCEE	positive	group2
GLFLDTLKGAAKDVAGKLEGLKCKITGCKLP	positive	group2
MGALIKTGAKIIGSGAAGGLGTYIGHKILGK	positive	group1
GVLDILKNAAKNILAHAAEQI	negative	group2
GLLSGILGAGKNIVCGLSGLC	negative	group1
NAMRGAKRVWRHI	negative	group2
KKKYPEYGSLDLRRECRIGNGQCKNQCHENEIRIAYCIRPGTHCCLQQ	positive	group1
HLNKRVQRLLIGWLDWLK	negative	group1
GETDPNTQLLNDLGNNMAWGAALGAPGGLGSAALGAAGGALQTVGQGLIDHGPVNVFIPVLIGPSWNGSGSGYNSATSSSGSGS	negative	group1
GVIDAAKKVVNVLANLF	positive	group1
FLPFLIPALTSLISSL	positive	group1
KRFKKFFKKLKNSVKKRAKKFFKKPRVIGVSIPF	negative	group1
ASSGWVCTLTIECGTVICACR	positive	group2
FLSAITSLLGKLL	positive	group1
LSVDKRPVLHPEHIYGHNHY	negative	group1
ILKKWPWWPWRRK	positive	group1
GLLSFLPKVIGVIGHLIHPPS	positive	group2
SFHVFPPWMCKSLKKC	negative	group1
KKLALKALKLWLLALKKLALLALKK	negative	group2
KWKSFIKKLLSKFLHSAKKF	negative	group1
KFFKKLKNSVKKRAKKFFKKPRVIGVSIPF	positive	group2
GLKEIFKAGLGSLVKGIAAHVAS	negative	group1
GGAGHVPEYFVGIGTPISFYG	negative	group1
GLLGGLLGPLLGGGGGGGGGLL	negative	group1
SLQPGAPNINNKDQPWQVSPHISRDDNGNTRTNINVQRHGENNDFEAGWSKVVRGPNKAKPTWHIGGTHRW	negative	group1
QLKKCWNNYVQGHCRKICRVNEVPEALCENGRYCCLNIKELEAC	negative	group1
GIFPKIIGKGIKTGIVNGIKSLVKGVGMKVFKAGLNNIGNTGCNEDEC	negative	group1
KFFKKLKNSVKKRAKKFFKKPKVIGVTFPF	positive	group2
AKCLRWQWAMRKYGG	negative	group1
KKLAKALKLLAPLWLKLAKALKKA	negative	group1
AKCLRWQWEMRKYGG	negative	group1
KWKSFIKKLTSKFLHSANKF	negative	group2
VLSIVACSSGCGSGKTAASCVETCGNRCFTNVGSLC	positive	group1
AFKLLGRIIHHVGNFVYGFSHVF	positive	group1
KWKSFIKKLTSAAKKVVTTAKPLISS	negative	group1
KLFKKIGIGAVLKVLTTGLPALKLTK	negative	group1
AVNIPFKVHLRCKAAFC	negative	group1
ILAWKWAWWAWRR	positive	group2
FISAIASFLGKFL	positive	group1
DYHHGVRVL	negative	group1
GVIDAAAKVVNVLKNLF	positive	group2
KKINNPVSCLRKGGRCWNRCIGNTRQIGSCGVPFLKCCKRK	negative	group1
DQYRCLQNGGFCLRSSCPSHTKLQGTCKPDKPNCCRS	negative	group1
ADDKNPLEEFRETNYEVFLEIAKNGLKATSNPKRVVIVGAGMAGLSAAY	negative	group1
FLGALWNVKKSVF	positive	group1
GLFDIVKKIAGHIAGSI	positive	group1
RLFIKKLKFITRR	negative	group1
IIEKLVNTALGLLSGL	positive	group1
VGHNADLQIKLSIRRLLAAGVLKQTKGVGA	negative	group2
KKLKLALAKLALLWKALALKLKKA	negative	group1
CVKVSVKVGSGVKVSVKVC	negative	group1
GFGSKPLDSFGLNFF	positive	group1
RQRDPQQQYEQCQERCQRHETEPRHMQTCQQRCERRYEKEKRKQQKR	positive	group1
KLLKWLLK	positive	group1
IGPDTKKCVQRKNACHYFECPWLYYSVGTCYKGKGKCCQKRY	negative	group2
QLEARFEPKQRNFRKRELDFEKLFANMPDY	positive	group1
GCPQTPRCTNYAEKGQCPPN	negative	group2
AYSLQMGATAIKQVKKLFKKWGW	positive	group1
GVNMYIRQIYDTCWKLKGHCRNVCGKKEIFHIFCGTQFLCCIERKEMPVLFVK	negative	group1
IHHIHHIIHHIHHIIHHIHHIIHHIHHI	negative	group1
KWNSFIKKLTSKFLHSAKKF	negative	group1
FFSASCVPGADKGQFPNLCRLCAGTGENKCA	negative	group2
GLGSILGKILNVAGKVGKTIGKVADAVGNKE	negative	group1
KWKLFKKIGIGAVLKVLTTGLPALKLTLK	negative	group1
KWKSFIKKLTSVLKKVVTTAKPLISS	negative	group1
KLLKKGGKLLKKGGKLLKKGG	negative	group1
LLGNFFRKSKQKIGKQFKRIVQRIKNFFRNLVPRTQS	positive	group1
FWGKLWEGVKNAI	negative	group1
GFKDWIKGAAKKLIKTVAANIANQ	negative	group1
GFFGNAWKKIKGKAEKFFRKKAAKIIAKKEGITKEEAEAKVDTMSKKQIKVYLLKHYGKKALQKASEKL	negative	group1
GSQLVYREWVGHSNVIKP	positive	group1
GIGAAILSAGKSIIKGLANGLAEHF	negative	group2
KKLKLALAKPALLWKALALKLKKA	negative	group1
KAAKKFAKAWAKAFKAA	negative	group1
AGCIKNGGRCNASAGPPYCCSSYCFQIAGQSYGVCKNR	positive	group1
KWKSFIKKLPKAAKKVVTTAKKPLIV	negative	group1
ATCDLASGFGVGSSLCAAHCLVKGYRGGYCKNKICHCRDKF	positive	group1
SYSMEHFRWGKPV	positive	group1
KWKSFIKKLTSKFLHSAKKF	negative	group1
ATCDLASIFNWNHALCAAHCIARRYRGGYCNSKAVCVCR	positive	group1
KLWKLFKKIGIGAVLKVLTTGLPALKLTK	negative	group1
ISAAEFGKINGPIKK	negative	group2
AGDPLADPNSQIVRQIMSNAAWGPPLVPERFRGMAVGAAGGVTQTVLQGAAAHMPVNVPIPKVPMGPSWNGSKG	negative	group1
KWKSFIKKLPSAAKKVTTAAKPLTK	negative	group1
GLWNTKLEAGLLFAMGKLDLKRCLKAGGC	negative	group1
MTPFWRGVSLRPVGASCRDNSECITMLCRKNRCFLRTASE	negative	group1
FLPIIAKVLSGLL	positive	group1
MPCSCKKYCDPWEVIDGSCGLFNSKYICCREK	negative	group1
KKLALALKKLAPLWKKLALALKKA	negative	group1
FLSAIASMLGKFL	positive	group1
FLPFLATLLSKVL	positive	group1
CWKWKWKWGSGWKWKWKWC	negative	group1
MRTGNAN	negative	group2
LFRKQLKW	negative	group1
KFRKFGKQVWVRL	negative	group2
ILGPVLGLVSDTLDDVLGIL	positive	group1
GMWSKIKNAGKAAKAAAKAAGKAALGAVSEAM	negative	group2
KKKKKKNGFAAWGAFGA	negative	group1
YYNPLPHDCGRDNNTDICSR	negative	group1
KKLALAPKKLALLWKKLALALKKA	negative	group1
QQCGRQAGNRRCANNLCCSQYGYCGRTNEYCCTSQGCQSQCRRCG	positive	group1
QWGYGGYGRGYGGYGGYGRGMYGGYGRGMYGGYGRGMYGGYGRGMYGGWGK	negative	group1
GFFGNTWKKIKGKADKIMLKKAVKIMVKKEGISKEEAQAKVDAMSKKQIRLYVLKHYGKKALQKASEKL	negative	group1
TCRTNRPCFYDLDLNVCRCS	negative	group1
FLFSLIPSVIAGLVSAIRN	positive	group1
KFKSFIKKLTSKFLHSAKKF	negative	group1
GNAACVIGCIGSCVISEGIGSLVGTAFTLG	positive	group1
FLFSLIPNAISGLLSAFK	positive	group1
APRKQLKW	negative	group2
KYYGNGVSCNKKGCSVDWGKAIGIIGNNSAANLATGGAAGWSK	positive	group1
TCRYWCKTPENQTYCCEDEREIPSKVGLKPGKCPPVRPVCPPTRGFFEPPKTCSNDGSCYGADKCCFDRCLGEHVCKPIQTRG	positive	group1
MRTGNAD	negative	group1
GFLSTVKNLATNVAGTVIDTLKCKVTGGCRS	negative	group1
PLSCRRKGGICILIRCPGPMRQIGTCFGRPVKCCR	negative	group1
GLWSKIKEAAKTAGKAAMGFVNEMV	positive	group1
GFGCPLNQGACHNHCRSIRRRGGYCSGIIKQTCTCY	positive	group1
EKYTEAPEYI	positive	group1
LLKWLLK	positive	group1
SILPTIVSFLSKFL	positive	group2
KWKSFIKKLTSKFLHSKKKF	negative	group1
CVWGGDCTDFLGCGTAWICV	positive	group2
IIGHLIKTALGMLGL	positive	group1
MNFNKFFVLFALIMVAVVGQSEAGWLKKLGKKIERVGQHTRDATIQTIGVAQQAVNVAATLKG	negative	group1
ECELAKVDGGYTPKNCAMAVGGGMLSGAIRGGMSGTVFGVGTGNLAGAFAGAHIGLVAGGLACIGGYLGSH	positive	group1
APRKNLKW	negative	group1
WNDTGKDADGSEY	positive	group1
GWLRKIGKKIERVGQHTRDATIQVLGIAQQAANVAATAR	negative	group2
RADTQTYQPYNKDWIKEKIYVLLRRQAQQAGK	positive	group2
ITSHSLCTPGCAKTGSFNSFCC	positive	group1
ARSYGNGVYCNNKKCWVNRGEATQSIIGGMISGWASGLAGM	positive	group1
GFFDLAKKVVGGIRNALGI	positive	group1
GLVSSIGRALGGLLADVVKSKGQPA	negative	group1
GYGGHGGHGGHGGHGGHGGHGHGGGGHG	negative	group1
HLLKRVQRELIRWLDWLK	negative	group2
LPVNSPMNKGDTEVMKCIVEVISDTLSKPSPMPVSKECFETLRGDERILSILRHQNLLKELQDLALQGAKERTHQQ	positive	group1
ADDKNPLEECFRETDYEEFLEIARNGLKATSNPKRVV	positive	group2
